user_id,operator_id,in_attempts,in_missed,wait_sum_all,wait_sum_answered,out_count,total_calls,internal_calls,answered_in,in_missed_rate,asa,avg_wait_in_all,internal_share,outbound_enabled
166377,880020,8,0,58,58,46,54,4,8,0.0,7.25,7.25,0.07407407407407407,True
166377,880022,8,0,112,112,211,219,15,8,0.0,14.0,14.0,0.0684931506849315,True
166377,880026,25,0,150,150,2414,2439,21,25,0.0,6.0,6.0,0.008610086100861008,True
166377,880028,70,0,398,398,2836,2906,9,70,0.0,5.685714285714286,5.685714285714286,0.0030970406056434964,True
166377,881278,0,0,0,0,20,20,8,0,,,,0.4,True
166391,882476,3,0,95,95,0,3,0,3,0.0,31.666666666666668,31.666666666666668,0.0,False
166391,882478,3,0,76,76,1,4,3,3,0.0,25.333333333333332,25.333333333333332,0.75,True
166392,886892,2,0,58,58,0,2,0,2,0.0,29.0,29.0,0.0,False
166392,891900,36,0,1338,1338,0,36,0,36,0.0,37.166666666666664,37.166666666666664,0.0,False
166392,891906,77,0,2043,2043,0,77,0,77,0.0,26.532467532467532,26.532467532467532,0.0,False
166399,886674,14,0,193,193,0,14,0,14,0.0,13.785714285714286,13.785714285714286,0.0,False
166405,882684,643,4,9970,9904,721,1364,10,639,0.006220839813374806,15.499217527386541,15.505443234836703,0.007331378299120235,True
166405,882686,837,6,12066,11995,3094,3931,10,831,0.007168458781362007,14.434416365824308,14.415770609318997,0.0025438819638768763,True
166405,882688,20,0,853,853,62,82,0,20,0.0,42.65,42.65,0.0,True
166405,882690,176,2,7196,7076,1590,1766,1,174,0.011363636363636364,40.666666666666664,40.88636363636363,0.0005662514156285391,True
166405,902510,137,2,4461,4395,1980,2117,1,135,0.014598540145985401,32.55555555555556,32.56204379562044,0.0004723665564478035,True
166405,902532,277,1,4479,4368,939,1216,11,276,0.0036101083032490976,15.826086956521738,16.169675090252706,0.009046052631578948,True
166405,939470,19,0,257,257,729,748,2,19,0.0,13.526315789473685,13.526315789473685,0.00267379679144385,True
166405,939474,217,0,3202,3202,603,820,0,217,0.0,14.755760368663594,14.755760368663594,0.0,True
166405,939476,54,1,496,491,877,931,0,53,0.018518518518518517,9.264150943396226,9.185185185185185,0.0,True
166405,939478,22,1,613,605,105,127,3,21,0.045454545454545456,28.80952380952381,27.863636363636363,0.023622047244094488,True
166406,879896,60,0,619,619,1071,1131,58,60,0.0,10.316666666666666,10.316666666666666,0.05128205128205128,True
166406,879898,118,0,1805,1805,7856,7974,19,118,0.0,15.296610169491526,15.296610169491526,0.002382743917732631,True
166406,880240,0,0,0,0,49,49,7,0,,,,0.14285714285714285,True
166407,888532,12,2,289,183,206,218,205,10,0.16666666666666666,18.3,24.083333333333332,0.9403669724770642,True
166407,888534,61,2,1756,1710,337,398,99,59,0.03278688524590164,28.983050847457626,28.78688524590164,0.24874371859296482,True
166407,888536,2,0,43,43,58,60,57,2,0.0,21.5,21.5,0.95,True
166407,888538,1,0,24,24,6,7,4,1,0.0,24.0,24.0,0.5714285714285714,True
166407,888540,3,0,59,59,17,20,16,3,0.0,19.666666666666668,19.666666666666668,0.8,True
166407,907440,6,0,143,143,191,197,158,6,0.0,23.833333333333332,23.833333333333332,0.8020304568527918,True
166407,907442,0,0,0,0,93,93,47,0,,,,0.5053763440860215,True
166407,960950,0,0,0,0,19,19,19,0,,,,1.0,True
166428,882680,109,3,1707,1614,0,109,2,106,0.027522935779816515,15.226415094339623,15.660550458715596,0.01834862385321101,False
166428,898676,3,0,25,25,0,3,0,3,0.0,8.333333333333334,8.333333333333334,0.0,False
166428,928202,32,0,506,506,0,32,1,32,0.0,15.8125,15.8125,0.03125,False
166481,884294,1,0,6,6,0,1,0,1,0.0,6.0,6.0,0.0,False
166482,934074,38,1,545,531,0,38,0,37,0.02631578947368421,14.35135135135135,14.342105263157896,0.0,False
166482,934076,11,1,311,266,0,11,0,10,0.09090909090909091,26.6,28.272727272727273,0.0,False
166485,887276,458,3,12836,12732,963,1421,290,455,0.006550218340611353,27.982417582417582,28.026200873362445,0.20408163265306123,True
166485,887278,54,0,929,929,274,328,240,54,0.0,17.203703703703702,17.203703703703702,0.7317073170731707,True
166485,887280,0,0,0,0,8,8,0,0,,,,0.0,True
166485,887282,29,0,1321,1321,2423,2452,5,29,0.0,45.55172413793103,45.55172413793103,0.0020391517128874386,True
166485,906866,0,0,0,0,655,655,13,0,,,,0.01984732824427481,True
166485,907174,10,0,623,623,2863,2873,9,10,0.0,62.3,62.3,0.003132613992342499,True
166487,959312,58,7,435,420,156,214,49,51,0.1206896551724138,8.235294117647058,7.5,0.22897196261682243,True
166495,883940,8,0,100,100,686,694,0,8,0.0,12.5,12.5,0.0,True
166495,883942,99,0,654,654,2228,2327,1,99,0.0,6.606060606060606,6.606060606060606,0.0004297378599054577,True
166503,884402,0,0,0,0,4,4,3,0,,,,0.75,True
166503,884406,0,0,0,0,6,6,6,0,,,,1.0,True
166503,884408,41,4,1074,992,25,66,20,37,0.0975609756097561,26.81081081081081,26.195121951219512,0.30303030303030304,True
166503,884412,20,0,820,820,843,863,23,20,0.0,41.0,41.0,0.026651216685979143,True
166503,906680,215,2,7945,7914,170,385,35,213,0.009302325581395349,37.15492957746479,36.95348837209303,0.09090909090909091,True
166503,925106,23,0,650,650,0,23,4,23,0.0,28.26086956521739,28.26086956521739,0.17391304347826086,False
166507,883018,0,0,0,0,2,2,0,0,,,,0.0,True
166507,883898,0,0,0,0,1,1,0,0,,,,0.0,True
166511,891410,742,2,9752,9731,3031,3773,88,740,0.0026954177897574125,13.15,13.142857142857142,0.023323615160349854,True
166511,891414,528,1,6271,6256,2846,3374,124,527,0.001893939393939394,11.870967741935484,11.87689393939394,0.036751630112625965,True
166511,891416,152,0,2331,2331,814,966,62,152,0.0,15.335526315789474,15.335526315789474,0.06418219461697723,True
166520,884946,12,0,159,159,2030,2042,2,12,0.0,13.25,13.25,0.0009794319294809011,True
166520,885682,0,0,0,0,3,3,0,0,,,,0.0,True
166520,890232,0,0,0,0,39,39,0,0,,,,0.0,True
166520,890234,0,0,0,0,1,1,0,0,,,,0.0,True
166520,891192,0,0,0,0,1,1,0,0,,,,0.0,True
166520,892028,0,0,0,0,1554,1554,4,0,,,,0.002574002574002574,True
166520,893674,0,0,0,0,2701,2701,5,0,,,,0.0018511662347278786,True
166520,897894,0,0,0,0,19,19,0,0,,,,0.0,True
166520,909452,0,0,0,0,8,8,0,0,,,,0.0,True
166520,910902,0,0,0,0,17,17,0,0,,,,0.0,True
166520,910926,0,0,0,0,25,25,0,0,,,,0.0,True
166520,923250,0,0,0,0,182,182,0,0,,,,0.0,True
166520,923254,1,0,45,45,9,10,0,1,0.0,45.0,45.0,0.0,True
166520,930510,2,0,44,44,2,4,0,2,0.0,22.0,22.0,0.0,True
166520,930524,0,0,0,0,28,28,0,0,,,,0.0,True
166520,939236,0,0,0,0,5,5,0,0,,,,0.0,True
166520,947480,0,0,0,0,5,5,4,0,,,,0.8,True
166520,969600,0,0,0,0,29,29,0,0,,,,0.0,True
166533,884478,25,0,345,345,2336,2361,4,25,0.0,13.8,13.8,0.0016941973739940702,True
166536,884524,3,0,31,31,0,3,0,3,0.0,10.333333333333334,10.333333333333334,0.0,False
166536,900192,2,0,10,10,1,3,0,2,0.0,5.0,5.0,0.0,True
166536,900194,61,3,1335,1205,49,110,0,58,0.04918032786885246,20.775862068965516,21.885245901639344,0.0,True
166536,925826,169,1,1178,1174,539,708,7,168,0.005917159763313609,6.988095238095238,6.970414201183432,0.009887005649717515,True
166536,925828,171,0,1064,1064,475,646,0,171,0.0,6.222222222222222,6.222222222222222,0.0,True
166541,908834,23,0,781,781,2,25,0,23,0.0,33.95652173913044,33.95652173913044,0.0,True
166541,908958,1010,4,27811,27694,132,1142,29,1006,0.0039603960396039604,27.52882703777336,27.535643564356434,0.025394045534150613,True
166541,908960,756,14,17704,17300,116,872,33,742,0.018518518518518517,23.315363881401616,23.417989417989418,0.03784403669724771,True
166541,910958,13,0,709,709,0,13,2,13,0.0,54.53846153846154,54.53846153846154,0.15384615384615385,False
166548,946468,1,0,25,25,0,1,0,1,0.0,25.0,25.0,0.0,False
166582,885876,1152,24,10500,10189,64897,66049,3,1128,0.020833333333333332,9.032801418439716,9.114583333333334,4.5420823933746156e-05,True
166582,885890,1363,27,12395,12126,64653,66016,0,1336,0.019809244314013204,9.076347305389222,9.09391049156273,0.0,True
166582,925922,456,11,3051,2951,21754,22210,0,445,0.02412280701754386,6.631460674157303,6.690789473684211,0.0,True
166585,889638,4,0,58,58,0,4,0,4,0.0,14.5,14.5,0.0,False
166604,893400,3,0,70,70,3,6,2,3,0.0,23.333333333333332,23.333333333333332,0.3333333333333333,True
166604,893402,368,3,5970,5907,56,424,9,365,0.008152173913043478,16.183561643835617,16.222826086956523,0.02122641509433962,True
166604,893420,209,1,4355,4318,36,245,4,208,0.004784688995215311,20.759615384615383,20.83732057416268,0.0163265306122449,True
166609,886146,1,0,9,9,51,52,0,1,0.0,9.0,9.0,0.0,True
166609,887992,0,0,0,0,47,47,0,0,,,,0.0,True
166609,892798,1,0,43,43,36,37,0,1,0.0,43.0,43.0,0.0,True
166609,892800,0,0,0,0,10,10,0,0,,,,0.0,True
166609,895370,0,0,0,0,10,10,0,0,,,,0.0,True
166619,897872,4,1,82,52,53,57,4,3,0.25,17.333333333333332,20.5,0.07017543859649122,True
166636,890582,114,1,1465,1460,67,181,6,113,0.008771929824561403,12.920353982300885,12.850877192982455,0.03314917127071823,True
166649,887416,22,0,369,369,0,22,0,22,0.0,16.772727272727273,16.772727272727273,0.0,False
166658,890402,548,0,5709,5709,1380,1928,1,548,0.0,10.417883211678832,10.417883211678832,0.0005186721991701245,True
166658,890404,582,2,6178,6161,1484,2066,5,580,0.003436426116838488,10.622413793103448,10.615120274914089,0.002420135527589545,True
166658,890406,474,5,4444,4380,1347,1821,2,469,0.010548523206751054,9.339019189765459,9.375527426160337,0.001098297638660077,True
166658,890410,16,0,108,108,1353,1369,5,16,0.0,6.75,6.75,0.003652300949598247,True
166658,890412,29,0,503,503,1344,1373,1,29,0.0,17.344827586206897,17.344827586206897,0.0007283321194464676,True
166658,890416,0,0,0,0,1380,1380,0,0,,,,0.0,True
166658,890420,0,0,0,0,746,746,0,0,,,,0.0,True
166658,890422,0,0,0,0,487,487,0,0,,,,0.0,True
166658,891152,0,0,0,0,286,286,0,0,,,,0.0,True
166658,891154,0,0,0,0,603,603,3,0,,,,0.004975124378109453,True
166658,891156,0,0,0,0,24,24,0,0,,,,0.0,True
166658,891158,0,0,0,0,305,305,2,0,,,,0.006557377049180328,True
166658,891160,0,0,0,0,426,426,0,0,,,,0.0,True
166658,891162,0,0,0,0,114,114,0,0,,,,0.0,True
166658,891166,0,0,0,0,275,275,0,0,,,,0.0,True
166658,891170,0,0,0,0,219,219,0,0,,,,0.0,True
166658,955436,1,0,23,23,0,1,0,1,0.0,23.0,23.0,0.0,False
166660,887802,20,0,258,258,125,145,1,20,0.0,12.9,12.9,0.006896551724137931,True
166660,932460,29,1,489,471,0,29,0,28,0.034482758620689655,16.821428571428573,16.862068965517242,0.0,False
166666,889640,2,0,27,27,0,2,0,2,0.0,13.5,13.5,0.0,False
166669,888406,9,1,255,238,6,15,0,8,0.1111111111111111,29.75,28.333333333333332,0.0,True
166671,888520,6,0,94,94,0,6,0,6,0.0,15.666666666666666,15.666666666666666,0.0,False
166677,890618,78,1,89,88,279,357,0,77,0.01282051282051282,1.1428571428571428,1.141025641025641,0.0,True
166678,888868,23,1,458,443,54,77,18,22,0.043478260869565216,20.136363636363637,19.91304347826087,0.23376623376623376,True
166678,900892,358,3,2445,2431,1023,1381,39,355,0.008379888268156424,6.847887323943662,6.829608938547486,0.028240405503258507,True
166678,900894,114,1,1359,1347,228,342,10,113,0.008771929824561403,11.920353982300885,11.921052631578947,0.029239766081871343,True
166678,925808,11,0,209,209,0,11,2,11,0.0,19.0,19.0,0.18181818181818182,False
166678,934608,10,0,135,135,0,10,0,10,0.0,13.5,13.5,0.0,False
166678,942214,3,0,30,30,0,3,2,3,0.0,10.0,10.0,0.6666666666666666,False
166680,891744,5,0,107,107,9,14,0,5,0.0,21.4,21.4,0.0,True
166680,891746,0,0,0,0,37,37,0,0,,,,0.0,True
166680,908984,0,0,0,0,13,13,0,0,,,,0.0,True
166680,915614,2,0,56,56,76,78,0,2,0.0,28.0,28.0,0.0,True
166680,916596,0,0,0,0,30,30,0,0,,,,0.0,True
166680,917234,5,0,69,69,1220,1225,2,5,0.0,13.8,13.8,0.0016326530612244899,True
166680,919418,0,0,0,0,2,2,0,0,,,,0.0,True
166680,932050,0,0,0,0,145,145,0,0,,,,0.0,True
166680,932088,0,0,0,0,12,12,0,0,,,,0.0,True
166680,932498,1,0,11,11,341,342,0,1,0.0,11.0,11.0,0.0,True
166680,932500,9,0,159,159,1189,1198,0,9,0.0,17.666666666666668,17.666666666666668,0.0,True
166680,932502,5,0,81,81,756,761,0,5,0.0,16.2,16.2,0.0,True
166680,941628,1,0,19,19,147,148,0,1,0.0,19.0,19.0,0.0,True
166680,943050,0,0,0,0,85,85,0,0,,,,0.0,True
166680,950444,0,0,0,0,95,95,1,0,,,,0.010526315789473684,True
166680,954642,0,0,0,0,417,417,0,0,,,,0.0,True
166680,960294,1,0,36,36,296,297,0,1,0.0,36.0,36.0,0.0,True
166680,960296,2,0,126,126,201,203,0,2,0.0,63.0,63.0,0.0,True
166680,972408,0,0,0,0,8,8,0,0,,,,0.0,True
166680,972410,0,0,0,0,77,77,0,0,,,,0.0,True
166680,972412,1,0,25,25,60,61,0,1,0.0,25.0,25.0,0.0,True
166688,890226,4,0,90,90,3,7,0,4,0.0,22.5,22.5,0.0,True
166688,890228,6,1,104,67,103,109,3,5,0.16666666666666666,13.4,17.333333333333332,0.027522935779816515,True
166688,965328,0,0,0,0,28,28,1,0,,,,0.03571428571428571,True
166691,889410,464,0,2932,2932,1104,1568,1,464,0.0,6.318965517241379,6.318965517241379,0.0006377551020408163,True
166691,901734,30,0,426,426,0,30,0,30,0.0,14.2,14.2,0.0,False
166692,898892,12,0,199,199,90,102,0,12,0.0,16.583333333333332,16.583333333333332,0.0,True
166697,891646,8,0,164,164,0,8,0,8,0.0,20.5,20.5,0.0,False
166708,899082,713,1,14577,14553,1659,2372,1,712,0.001402524544179523,20.439606741573034,20.444600280504908,0.00042158516020236085,True
166711,891250,0,0,0,0,2,2,0,0,,,,0.0,True
166711,891252,0,0,0,0,98,98,0,0,,,,0.0,True
166711,891254,2,0,52,52,0,2,0,2,0.0,26.0,26.0,0.0,False
166711,891970,0,0,0,0,21,21,0,0,,,,0.0,True
166713,891908,40,0,411,411,11,51,2,40,0.0,10.275,10.275,0.0392156862745098,True
166713,891918,7,0,223,223,1,8,0,7,0.0,31.857142857142858,31.857142857142858,0.0,True
166717,891988,441,0,4079,4079,503,944,0,441,0.0,9.249433106575964,9.249433106575964,0.0,True
166725,889754,511,2,4074,4057,1342,1853,1,509,0.003913894324853229,7.970530451866405,7.972602739726027,0.0005396654074473826,True
166726,903390,9,0,142,142,0,9,0,9,0.0,15.777777777777779,15.777777777777779,0.0,False
166727,895170,11,0,161,161,0,11,0,11,0.0,14.636363636363637,14.636363636363637,0.0,False
166732,894224,17,1,158,153,33,50,43,16,0.058823529411764705,9.5625,9.294117647058824,0.86,True
166732,894226,0,0,0,0,25,25,20,0,,,,0.8,True
166732,894230,6,1,95,91,15,21,20,5,0.16666666666666666,18.2,15.833333333333334,0.9523809523809523,True
166732,894232,5,1,56,52,16,21,21,4,0.2,13.0,11.2,1.0,True
166732,909624,3,0,101,101,0,3,2,3,0.0,33.666666666666664,33.666666666666664,0.6666666666666666,False
166774,891824,12,0,195,195,34,46,0,12,0.0,16.25,16.25,0.0,True
166774,891976,0,0,0,0,2,2,0,0,,,,0.0,True
166774,894934,0,0,0,0,20,20,0,0,,,,0.0,True
166774,895266,3,0,37,37,1,4,0,3,0.0,12.333333333333334,12.333333333333334,0.0,True
166782,893804,2632,12,13502,13432,3938,6570,48,2620,0.004559270516717325,5.126717557251909,5.129939209726444,0.0073059360730593605,True
166782,894120,24,1,493,457,0,24,0,23,0.041666666666666664,19.869565217391305,20.541666666666668,0.0,False
166782,899250,309,5,5019,4969,1670,1979,2,304,0.016181229773462782,16.345394736842106,16.24271844660194,0.001010611419909045,True
166782,900180,17,0,139,139,1887,1904,42,17,0.0,8.176470588235293,8.176470588235293,0.022058823529411766,True
166782,919994,21,0,893,893,0,21,0,21,0.0,42.523809523809526,42.523809523809526,0.0,False
166800,892530,11,0,362,362,10,21,1,11,0.0,32.90909090909091,32.90909090909091,0.047619047619047616,True
166800,892532,74,0,2166,2166,102,176,1,74,0.0,29.27027027027027,29.27027027027027,0.005681818181818182,True
166800,892534,35,0,1165,1165,11,46,0,35,0.0,33.285714285714285,33.285714285714285,0.0,True
166800,892536,17,0,617,617,17,34,0,17,0.0,36.294117647058826,36.294117647058826,0.0,True
166800,892538,12,0,367,367,123,135,0,12,0.0,30.583333333333332,30.583333333333332,0.0,True
166803,891946,17,0,344,344,35,52,4,17,0.0,20.235294117647058,20.235294117647058,0.07692307692307693,True
166803,891948,1,0,3,3,0,1,0,1,0.0,3.0,3.0,0.0,False
166803,893172,43,0,995,995,3,46,3,43,0.0,23.13953488372093,23.13953488372093,0.06521739130434782,True
166812,900594,35,0,375,375,215,250,0,35,0.0,10.714285714285714,10.714285714285714,0.0,True
166813,900614,26,0,268,268,40,66,0,26,0.0,10.307692307692308,10.307692307692308,0.0,True
166813,954318,1,0,4,4,1,2,0,1,0.0,4.0,4.0,0.0,True
166813,954616,7,0,46,46,0,7,0,7,0.0,6.571428571428571,6.571428571428571,0.0,False
166813,955820,0,0,0,0,9,9,0,0,,,,0.0,True
166833,903254,262,0,4432,4432,1583,1845,1,262,0.0,16.916030534351144,16.916030534351144,0.0005420054200542005,True
166836,901350,111,0,2762,2762,0,111,0,111,0.0,24.882882882882882,24.882882882882882,0.0,False
166837,910038,2,0,30,30,0,2,0,2,0.0,15.0,15.0,0.0,False
166837,910044,19,0,282,282,0,19,0,19,0.0,14.842105263157896,14.842105263157896,0.0,False
166837,910226,8,2,132,106,0,8,0,6,0.25,17.666666666666668,16.5,0.0,False
166837,913886,2,1,27,16,0,2,0,1,0.5,16.0,13.5,0.0,False
166837,919896,8,2,109,77,0,8,0,6,0.25,12.833333333333334,13.625,0.0,False
166837,924662,1,0,20,20,0,1,0,1,0.0,20.0,20.0,0.0,False
166837,930242,4,1,69,45,0,4,0,3,0.25,15.0,17.25,0.0,False
166837,945710,1,0,17,17,0,1,0,1,0.0,17.0,17.0,0.0,False
166839,894614,8,1,115,85,0,8,0,7,0.125,12.142857142857142,14.375,0.0,False
166839,902720,105,0,1703,1703,2617,2722,16,105,0.0,16.21904761904762,16.21904761904762,0.005878030859662013,True
166843,895140,4,0,152,152,0,4,0,4,0.0,38.0,38.0,0.0,False
166843,895172,9,0,105,105,86,95,3,9,0.0,11.666666666666666,11.666666666666666,0.031578947368421054,True
166843,913474,2,0,74,74,11,13,0,2,0.0,37.0,37.0,0.0,True
166843,913868,19,0,48,48,25,44,14,19,0.0,2.526315789473684,2.526315789473684,0.3181818181818182,True
166843,926312,10,0,135,135,130,140,1,10,0.0,13.5,13.5,0.007142857142857143,True
166874,893700,0,0,0,0,8,8,0,0,,,,0.0,True
166874,895598,3,0,18,18,2,5,0,3,0.0,6.0,6.0,0.0,True
166879,896536,208,2,4366,4326,0,208,5,206,0.009615384615384616,21.0,20.990384615384617,0.02403846153846154,False
166879,896538,14,1,665,623,0,14,0,13,0.07142857142857142,47.92307692307692,47.5,0.0,False
166879,903512,28,0,1190,1190,0,28,3,28,0.0,42.5,42.5,0.10714285714285714,False
166879,927070,42,0,1848,1848,0,42,0,42,0.0,44.0,44.0,0.0,False
166884,895774,13,0,142,142,118,131,0,13,0.0,10.923076923076923,10.923076923076923,0.0,True
166884,895776,12,1,175,161,252,264,1,11,0.08333333333333333,14.636363636363637,14.583333333333334,0.003787878787878788,True
166884,917890,0,0,0,0,2,2,0,0,,,,0.0,True
166896,895574,99,3,1505,1482,0,99,0,96,0.030303030303030304,15.4375,15.202020202020202,0.0,False
166896,895576,80,1,1413,1390,0,80,0,79,0.0125,17.59493670886076,17.6625,0.0,False
166896,895578,64,0,935,935,0,64,0,64,0.0,14.609375,14.609375,0.0,False
166899,894656,20,0,483,483,3396,3416,0,20,0.0,24.15,24.15,0.0,True
166899,894662,1,0,9,9,48,49,3,1,0.0,9.0,9.0,0.061224489795918366,True
166901,896008,0,0,0,0,202,202,202,0,,,,1.0,True
166901,896010,10,0,186,186,5,15,2,10,0.0,18.6,18.6,0.13333333333333333,True
166901,896012,270,1,1611,1605,0,270,0,269,0.003703703703703704,5.966542750929368,5.966666666666667,0.0,False
166901,896014,19,0,274,274,9,28,2,19,0.0,14.421052631578947,14.421052631578947,0.07142857142857142,True
166901,896016,83,0,636,636,294,377,87,83,0.0,7.662650602409639,7.662650602409639,0.23076923076923078,True
166901,896018,9,0,247,247,11,20,8,9,0.0,27.444444444444443,27.444444444444443,0.4,True
166901,896020,16,0,15,15,0,16,0,16,0.0,0.9375,0.9375,0.0,False
166908,895782,14,0,286,286,0,14,0,14,0.0,20.428571428571427,20.428571428571427,0.0,False
166908,895786,46,0,1017,1017,0,46,0,46,0.0,22.108695652173914,22.108695652173914,0.0,False
166916,906392,19,7,255,149,61,80,57,12,0.3684210526315789,12.416666666666666,13.421052631578947,0.7125,True
166916,906394,41,0,1204,1204,575,616,466,41,0.0,29.365853658536587,29.365853658536587,0.7564935064935064,True
166916,906396,129,3,3909,3739,440,569,333,126,0.023255813953488372,29.674603174603174,30.302325581395348,0.5852372583479789,True
166916,906398,64,0,1587,1587,43,107,36,64,0.0,24.796875,24.796875,0.3364485981308411,True
166916,906400,144,5,4120,3979,462,606,272,139,0.034722222222222224,28.62589928057554,28.61111111111111,0.44884488448844884,True
166916,906402,7,0,324,324,17,24,9,7,0.0,46.285714285714285,46.285714285714285,0.375,True
166916,906404,599,7,16571,16330,673,1272,116,592,0.011686143572621035,27.58445945945946,27.664440734557594,0.09119496855345911,True
166916,906406,836,3,22540,22456,1213,2049,318,833,0.0035885167464114833,26.95798319327731,26.961722488038276,0.15519765739385066,True
166916,906408,264,4,7586,7361,106,370,93,260,0.015151515151515152,28.31153846153846,28.734848484848484,0.25135135135135134,True
166916,906410,244,9,6300,6064,21,265,3,235,0.036885245901639344,25.804255319148936,25.81967213114754,0.011320754716981131,True
166916,906412,26,7,400,260,328,354,265,19,0.2692307692307692,13.68421052631579,15.384615384615385,0.748587570621469,True
166916,906416,6,0,98,98,82,88,68,6,0.0,16.333333333333332,16.333333333333332,0.7727272727272727,True
166916,906418,5,0,73,73,4,9,3,5,0.0,14.6,14.6,0.3333333333333333,True
166916,906420,5,0,55,55,33,38,29,5,0.0,11.0,11.0,0.7631578947368421,True
166916,928282,0,0,0,0,2,2,2,0,,,,1.0,True
166916,928284,0,0,0,0,2,2,2,0,,,,1.0,True
166936,896428,38,0,293,293,221,259,2,38,0.0,7.7105263157894735,7.7105263157894735,0.007722007722007722,True
166936,896430,1,0,13,13,18,19,0,1,0.0,13.0,13.0,0.0,True
166939,951332,9,0,279,279,5,14,4,9,0.0,31.0,31.0,0.2857142857142857,True
166939,954750,223,1,4878,4853,73,296,26,222,0.004484304932735426,21.86036036036036,21.87443946188341,0.08783783783783784,True
166939,955068,0,0,0,0,2,2,2,0,,,,1.0,True
166939,955082,0,0,0,0,14,14,14,0,,,,1.0,True
166939,955086,0,0,0,0,1,1,1,0,,,,1.0,True
166939,955090,0,0,0,0,28,28,28,0,,,,1.0,True
166939,955094,0,0,0,0,2,2,1,0,,,,0.5,True
166940,897030,6,0,76,76,76,82,2,6,0.0,12.666666666666666,12.666666666666666,0.024390243902439025,True
166940,900458,1,0,9,9,28,29,0,1,0.0,9.0,9.0,0.0,True
166940,910594,0,0,0,0,28,28,0,0,,,,0.0,True
166940,972460,2,0,8,8,68,70,3,2,0.0,4.0,4.0,0.04285714285714286,True
166941,896382,41,0,505,505,396,437,4,41,0.0,12.317073170731707,12.317073170731707,0.009153318077803204,True
166941,896384,0,0,0,0,30,30,0,0,,,,0.0,True
166941,896386,0,0,0,0,76,76,0,0,,,,0.0,True
166941,896390,0,0,0,0,97,97,0,0,,,,0.0,True
166941,896708,66,0,792,792,174,240,0,66,0.0,12.0,12.0,0.0,True
166946,900742,24,0,318,318,18,42,5,24,0.0,13.25,13.25,0.11904761904761904,True
166946,900746,26,2,611,582,51,77,4,24,0.07692307692307693,24.25,23.5,0.05194805194805195,True
166955,898558,23,0,655,655,0,23,0,23,0.0,28.47826086956522,28.47826086956522,0.0,False
166955,898560,21,0,674,674,0,21,0,21,0.0,32.095238095238095,32.095238095238095,0.0,False
166958,898422,65,1,472,468,36,101,0,64,0.015384615384615385,7.3125,7.2615384615384615,0.0,True
166971,914626,0,0,0,0,1,1,0,0,,,,0.0,True
166971,914630,25,0,294,294,143,168,0,25,0.0,11.76,11.76,0.0,True
166973,901584,125,0,721,721,189,314,4,125,0.0,5.768,5.768,0.012738853503184714,True
166973,901586,44,0,342,342,96,140,1,44,0.0,7.7727272727272725,7.7727272727272725,0.007142857142857143,True
166973,901588,31,0,180,180,60,91,1,31,0.0,5.806451612903226,5.806451612903226,0.01098901098901099,True
166974,900352,210,3,3602,3557,348,558,0,207,0.014285714285714285,17.183574879227052,17.152380952380952,0.0,True
166974,900354,174,4,2999,2948,534,708,0,170,0.022988505747126436,17.341176470588234,17.235632183908045,0.0,True
166975,899268,32,2,666,626,0,32,0,30,0.0625,20.866666666666667,20.8125,0.0,False
166975,899892,3,0,95,95,0,3,0,3,0.0,31.666666666666668,31.666666666666668,0.0,False
166975,899898,2,0,50,50,0,2,0,2,0.0,25.0,25.0,0.0,False
166975,899900,3,0,187,187,0,3,1,3,0.0,62.333333333333336,62.333333333333336,0.3333333333333333,False
166975,899906,1,0,19,19,0,1,0,1,0.0,19.0,19.0,0.0,False
166975,899912,1,0,19,19,0,1,0,1,0.0,19.0,19.0,0.0,False
166983,901880,2064,11,10768,10679,2591,4655,53,2053,0.005329457364341085,5.201656113005358,5.217054263565892,0.011385606874328678,True
166983,901884,614,1,8266,8259,2232,2846,130,613,0.0016286644951140066,13.473083197389887,13.462540716612377,0.04567814476458187,True
166983,901886,150,0,2880,2880,1636,1786,9,150,0.0,19.2,19.2,0.005039193729003359,True
166983,901894,30,0,742,742,0,30,0,30,0.0,24.733333333333334,24.733333333333334,0.0,False
166983,909134,215,1,7623,7581,6,221,1,214,0.004651162790697674,35.425233644859816,35.455813953488374,0.004524886877828055,True
166985,904284,49,0,771,771,0,49,0,49,0.0,15.73469387755102,15.73469387755102,0.0,False
166993,901178,329,0,2937,2937,29,358,10,329,0.0,8.927051671732523,8.927051671732523,0.027932960893854747,True
166997,903312,146,2,2582,2547,53,199,5,144,0.0136986301369863,17.6875,17.684931506849313,0.02512562814070352,True
166997,903318,314,3,2863,2844,1332,1646,53,311,0.009554140127388535,9.144694533762058,9.117834394904458,0.03219927095990279,True
166997,905430,114,1,777,765,835,949,2,113,0.008771929824561403,6.769911504424779,6.815789473684211,0.002107481559536354,True
166997,905432,12,0,64,64,959,971,0,12,0.0,5.333333333333333,5.333333333333333,0.0,True
166997,909502,0,0,0,0,865,865,1,0,,,,0.0011560693641618498,True
166997,914036,0,0,0,0,35,35,1,0,,,,0.02857142857142857,True
167002,900492,18,1,262,235,258,276,0,17,0.05555555555555555,13.823529411764707,14.555555555555555,0.0,True
167003,901492,39,0,941,941,3,42,0,39,0.0,24.128205128205128,24.128205128205128,0.0,True
167003,901498,5,0,265,265,0,5,0,5,0.0,53.0,53.0,0.0,False
167004,900826,99,0,1059,1059,549,648,0,99,0.0,10.696969696969697,10.696969696969697,0.0,True
167009,898414,32,1,334,328,59,91,0,31,0.03125,10.580645161290322,10.4375,0.0,True
167009,898902,0,0,0,0,22,22,0,0,,,,0.0,True
167009,898906,20,0,233,233,127,147,1,20,0.0,11.65,11.65,0.006802721088435374,True
167009,898920,13,0,194,194,66,79,0,13,0.0,14.923076923076923,14.923076923076923,0.0,True
167011,899788,0,0,0,0,655,655,3,0,,,,0.004580152671755725,True
167011,899790,0,0,0,0,731,731,0,0,,,,0.0,True
167011,899932,0,0,0,0,779,779,5,0,,,,0.006418485237483954,True
167011,899964,0,0,0,0,470,470,1,0,,,,0.002127659574468085,True
167011,899968,0,0,0,0,407,407,2,0,,,,0.004914004914004914,True
167011,899972,0,0,0,0,195,195,5,0,,,,0.02564102564102564,True
167012,898434,0,0,0,0,10,10,3,0,,,,0.3,True
167012,899076,0,0,0,0,2,2,1,0,,,,0.5,True
167016,916424,493,3,5008,4982,143,636,45,490,0.006085192697768763,10.16734693877551,10.158215010141987,0.07075471698113207,True
167016,962658,376,0,3035,3035,371,747,49,376,0.0,8.071808510638299,8.071808510638299,0.06559571619812583,True
167016,962902,244,0,1732,1732,458,702,45,244,0.0,7.098360655737705,7.098360655737705,0.0641025641025641,True
167016,962904,0,0,0,0,2,2,0,0,,,,0.0,True
167031,910516,35,0,783,783,0,35,0,35,0.0,22.37142857142857,22.37142857142857,0.0,False
167031,910520,0,0,0,0,227,227,0,0,,,,0.0,True
167031,910524,0,0,0,0,85,85,1,0,,,,0.011764705882352941,True
167031,910530,0,0,0,0,1077,1077,0,0,,,,0.0,True
167031,910532,0,0,0,0,214,214,0,0,,,,0.0,True
167035,923526,1017,2,7866,7851,2037,3054,0,1015,0.0019665683382497543,7.7349753694581285,7.734513274336283,0.0,True
167035,923528,126,2,3023,2951,676,802,1,124,0.015873015873015872,23.798387096774192,23.99206349206349,0.0012468827930174563,True
167052,904038,498,2,4354,4239,231,729,1,496,0.004016064257028112,8.546370967741936,8.742971887550201,0.0013717421124828531,True
167052,904044,117,1,2165,2161,27,144,0,116,0.008547008547008548,18.629310344827587,18.504273504273506,0.0,True
167053,903292,43,0,606,606,303,346,0,43,0.0,14.093023255813954,14.093023255813954,0.0,True
167059,911102,36,3,1075,998,0,36,0,33,0.08333333333333333,30.242424242424242,29.86111111111111,0.0,False
167059,911104,1,0,13,13,0,1,0,1,0.0,13.0,13.0,0.0,False
167059,911136,240,1,4766,4746,0,240,0,239,0.004166666666666667,19.85774058577406,19.858333333333334,0.0,False
167059,911138,316,4,6192,6122,0,316,0,312,0.012658227848101266,19.621794871794872,19.59493670886076,0.0,False
167059,911140,75,2,1965,1923,0,75,0,73,0.02666666666666667,26.34246575342466,26.2,0.0,False
167059,911142,26,3,1186,1087,0,26,0,23,0.11538461538461539,47.26086956521739,45.61538461538461,0.0,False
167059,911152,2,0,43,43,0,2,0,2,0.0,21.5,21.5,0.0,False
167060,930908,38,0,215,215,42,80,6,38,0.0,5.657894736842105,5.657894736842105,0.075,True
167060,930910,1,0,5,5,13,14,1,1,0.0,5.0,5.0,0.07142857142857142,True
167060,930912,0,0,0,0,246,246,4,0,,,,0.016260162601626018,True
167060,930914,0,0,0,0,329,329,7,0,,,,0.02127659574468085,True
167061,901034,13,0,159,159,12,25,1,13,0.0,12.23076923076923,12.23076923076923,0.04,True
167061,901038,5,0,114,114,33,38,10,5,0.0,22.8,22.8,0.2631578947368421,True
167071,913938,5221,15,44944,44776,436,5657,2,5206,0.002873012832790653,8.60084517864003,8.608312583796208,0.00035354428142124803,True
167071,913942,2641,55,31577,30766,468,3109,14,2586,0.020825444907232107,11.897138437741686,11.956455887921242,0.004503055644901898,True
167078,900592,285,0,1922,1922,121,406,6,285,0.0,6.743859649122807,6.743859649122807,0.014778325123152709,True
167078,935348,176,1,1329,1318,187,363,4,175,0.005681818181818182,7.531428571428571,7.551136363636363,0.011019283746556474,True
167078,956480,90,0,1292,1292,0,90,0,90,0.0,14.355555555555556,14.355555555555556,0.0,False
167078,956484,15,0,313,313,0,15,0,15,0.0,20.866666666666667,20.866666666666667,0.0,False
167078,963716,0,0,0,0,1,1,0,0,,,,0.0,True
167079,904058,19,0,311,311,0,19,0,19,0.0,16.36842105263158,16.36842105263158,0.0,False
167082,900788,131,1,855,850,93,224,0,130,0.007633587786259542,6.538461538461538,6.526717557251908,0.0,True
167082,900790,44,0,371,371,61,105,0,44,0.0,8.431818181818182,8.431818181818182,0.0,True
167082,900792,1,0,34,34,8,9,2,1,0.0,34.0,34.0,0.2222222222222222,True
167082,920982,61,0,1516,1516,0,61,0,61,0.0,24.852459016393443,24.852459016393443,0.0,False
167082,922356,22,0,575,575,0,22,0,22,0.0,26.136363636363637,26.136363636363637,0.0,False
167102,902906,49,0,846,846,0,49,0,49,0.0,17.26530612244898,17.26530612244898,0.0,False
167102,902910,31,1,818,789,0,31,0,30,0.03225806451612903,26.3,26.387096774193548,0.0,False
167109,906294,323,2,1525,1515,309,632,185,321,0.006191950464396285,4.719626168224299,4.7213622291021675,0.2927215189873418,True
167109,906296,6,0,96,96,230,236,185,6,0.0,16.0,16.0,0.7838983050847458,True
167109,907178,5,0,118,118,209,214,54,5,0.0,23.6,23.6,0.2523364485981308,True
167109,907180,0,0,0,0,87,87,39,0,,,,0.4482758620689655,True
167109,907182,72,0,767,767,267,339,253,72,0.0,10.652777777777779,10.652777777777779,0.7463126843657817,True
167109,907224,51,0,1176,1176,336,387,67,51,0.0,23.058823529411764,23.058823529411764,0.1731266149870801,True
167109,909910,0,0,0,0,344,344,105,0,,,,0.30523255813953487,True
167110,907998,0,0,0,0,2,2,0,0,,,,0.0,True
167110,908002,8,0,140,140,16,24,0,8,0.0,17.5,17.5,0.0,True
167112,904014,46,0,585,585,1429,1475,2,46,0.0,12.717391304347826,12.717391304347826,0.0013559322033898306,True
167112,904016,55,2,1045,994,5120,5175,5,53,0.03636363636363636,18.754716981132077,19.0,0.000966183574879227,True
167112,933452,0,0,0,0,4,4,0,0,,,,0.0,True
167112,942174,0,0,0,0,6,6,0,0,,,,0.0,True
167112,951648,0,0,0,0,161,161,0,0,,,,0.0,True
167112,951650,2,0,90,90,10,12,0,2,0.0,45.0,45.0,0.0,True
167113,902238,1,0,8,8,1,2,0,1,0.0,8.0,8.0,0.0,True
167122,909308,0,0,0,0,15,15,0,0,,,,0.0,True
167124,901992,13,0,104,104,817,830,0,13,0.0,8.0,8.0,0.0,True
167124,901996,3,0,43,43,26,29,2,3,0.0,14.333333333333334,14.333333333333334,0.06896551724137931,True
167125,902742,0,0,0,0,1232,1232,5,0,,,,0.004058441558441558,True
167125,902744,0,0,0,0,3457,3457,35,0,,,,0.0101243853051779,True
167125,902746,0,0,0,0,2748,2748,25,0,,,,0.009097525473071324,True
167125,902748,0,0,0,0,2831,2831,10,0,,,,0.0035323207347227126,True
167125,902774,0,0,0,0,1126,1126,10,0,,,,0.008880994671403197,True
167125,902776,0,0,0,0,1824,1824,19,0,,,,0.010416666666666666,True
167125,902778,0,0,0,0,1327,1327,16,0,,,,0.012057272042200452,True
167125,902782,0,0,0,0,1473,1473,11,0,,,,0.00746775288526816,True
167130,902608,14,0,141,141,219,233,13,14,0.0,10.071428571428571,10.071428571428571,0.055793991416309016,True
167139,950640,1,0,9,9,0,1,0,1,0.0,9.0,9.0,0.0,False
167141,905870,151,0,1750,1750,614,765,0,151,0.0,11.589403973509933,11.589403973509933,0.0,True
167144,903974,11,0,185,185,0,11,0,11,0.0,16.818181818181817,16.818181818181817,0.0,False
167144,903976,5,0,42,42,0,5,0,5,0.0,8.4,8.4,0.0,False
167144,903978,8,0,76,76,10,18,9,8,0.0,9.5,9.5,0.5,True
167144,905082,4,0,68,68,0,4,0,4,0.0,17.0,17.0,0.0,False
167150,905538,264,2,4673,4637,3579,3843,250,262,0.007575757575757576,17.698473282442748,17.700757575757574,0.06505334374186833,True
167150,905542,129,3,2344,2300,2173,2302,136,126,0.023255813953488372,18.253968253968253,18.170542635658915,0.059079061685490875,True
167150,905564,58,1,1432,1408,758,816,199,57,0.017241379310344827,24.70175438596491,24.689655172413794,0.24387254901960784,True
167150,905566,47,2,797,759,910,957,330,45,0.0425531914893617,16.866666666666667,16.95744680851064,0.3448275862068966,True
167150,905570,0,0,0,0,102,102,99,0,,,,0.9705882352941176,True
167150,905574,5,0,52,52,474,479,383,5,0.0,10.4,10.4,0.7995824634655533,True
167150,928092,5,0,236,236,0,5,0,5,0.0,47.2,47.2,0.0,False
167158,907502,263,2,5267,5220,0,263,0,261,0.0076045627376425855,20.0,20.026615969581748,0.0,False
167162,905300,29,6,650,508,0,29,0,23,0.20689655172413793,22.08695652173913,22.413793103448278,0.0,False
167172,904200,8,0,174,174,12,20,2,8,0.0,21.75,21.75,0.1,True
167172,904202,9,0,90,90,246,255,5,9,0.0,10.0,10.0,0.0196078431372549,True
167172,904204,5,0,161,161,59,64,15,5,0.0,32.2,32.2,0.234375,True
167172,926490,11,1,246,226,144,155,9,10,0.09090909090909091,22.6,22.363636363636363,0.05806451612903226,True
167172,929228,1,0,24,24,91,92,4,1,0.0,24.0,24.0,0.043478260869565216,True
167172,943818,1,0,5,5,26,27,2,1,0.0,5.0,5.0,0.07407407407407407,True
167175,905840,0,0,0,0,7,7,0,0,,,,0.0,True
167175,905842,2,0,231,231,1251,1253,0,2,0.0,115.5,115.5,0.0,True
167175,905844,18,0,227,227,1128,1146,0,18,0.0,12.61111111111111,12.61111111111111,0.0,True
167175,938842,0,0,0,0,113,113,0,0,,,,0.0,True
167176,904344,7,6,93,17,5,12,5,1,0.8571428571428571,17.0,13.285714285714286,0.4166666666666667,True
167176,904372,4,0,93,93,0,4,0,4,0.0,23.25,23.25,0.0,False
167176,905104,326,8,5607,5472,210,536,64,318,0.024539877300613498,17.20754716981132,17.199386503067483,0.11940298507462686,True
167176,905308,0,0,0,0,3,3,3,0,,,,1.0,True
167176,905470,0,0,0,0,3,3,3,0,,,,1.0,True
167176,905472,2,0,42,42,9,11,9,2,0.0,21.0,21.0,0.8181818181818182,True
167176,905478,1,0,36,36,0,1,0,1,0.0,36.0,36.0,0.0,False
167176,905480,0,0,0,0,1,1,1,0,,,,1.0,True
167176,907504,5,0,109,109,25,30,24,5,0.0,21.8,21.8,0.8,True
167176,907952,51,2,1047,1008,194,245,194,49,0.0392156862745098,20.571428571428573,20.529411764705884,0.7918367346938775,True
167176,907964,19,0,308,308,62,81,54,19,0.0,16.210526315789473,16.210526315789473,0.6666666666666666,True
167176,907970,18,0,315,315,172,190,171,18,0.0,17.5,17.5,0.9,True
167176,907982,76,1,1624,1608,89,165,83,75,0.013157894736842105,21.44,21.36842105263158,0.503030303030303,True
167176,907986,1,0,20,20,501,502,501,1,0.0,20.0,20.0,0.99800796812749,True
167176,907994,42,0,770,770,122,164,122,42,0.0,18.333333333333332,18.333333333333332,0.7439024390243902,True
167180,905930,80,0,499,499,407,487,28,80,0.0,6.2375,6.2375,0.057494866529774126,True
167180,905932,39,0,314,314,359,398,20,39,0.0,8.051282051282051,8.051282051282051,0.05025125628140704,True
167180,905934,1,0,9,9,21,22,4,1,0.0,9.0,9.0,0.18181818181818182,True
167183,932246,0,0,0,0,1,1,0,0,,,,0.0,True
167183,932292,6,0,88,88,109,115,0,6,0.0,14.666666666666666,14.666666666666666,0.0,True
167183,932304,2,0,40,40,56,58,1,2,0.0,20.0,20.0,0.017241379310344827,True
167185,912296,176,3,2032,1996,511,687,0,173,0.017045454545454544,11.53757225433526,11.545454545454545,0.0,True
167185,917680,2,0,200,200,43,45,0,2,0.0,100.0,100.0,0.0,True
167185,917682,0,0,0,0,7,7,0,0,,,,0.0,True
167188,907618,1,0,35,35,0,1,0,1,0.0,35.0,35.0,0.0,False
167188,908098,9,0,240,240,0,9,0,9,0.0,26.666666666666668,26.666666666666668,0.0,False
167188,908130,3,0,85,85,0,3,1,3,0.0,28.333333333333332,28.333333333333332,0.3333333333333333,False
167188,908152,15,0,600,600,0,15,1,15,0.0,40.0,40.0,0.06666666666666667,False
167188,908162,3,0,159,159,0,3,0,3,0.0,53.0,53.0,0.0,False
167188,908180,1,0,15,15,0,1,1,1,0.0,15.0,15.0,1.0,False
167188,908300,5,0,281,281,0,5,4,5,0.0,56.2,56.2,0.8,False
167188,909392,5,0,130,130,0,5,0,5,0.0,26.0,26.0,0.0,False
167188,914238,0,0,0,0,374,374,8,0,,,,0.0213903743315508,True
167188,914338,0,0,0,0,48,48,7,0,,,,0.14583333333333334,True
167188,914348,0,0,0,0,9,9,0,0,,,,0.0,True
167188,923646,2,0,38,38,0,2,2,2,0.0,19.0,19.0,1.0,False
167188,957022,0,0,0,0,21,21,12,0,,,,0.5714285714285714,True
167188,962168,4,0,69,69,0,4,1,4,0.0,17.25,17.25,0.25,False
167188,964716,0,0,0,0,326,326,6,0,,,,0.018404907975460124,True
167189,906070,361,2,13653,13545,89,450,0,359,0.00554016620498615,37.729805013927574,37.81994459833795,0.0,True
167189,906076,24,0,1223,1223,1,25,0,24,0.0,50.958333333333336,50.958333333333336,0.0,True
167199,911310,418,3,5668,5385,107,525,4,415,0.007177033492822967,12.975903614457831,13.559808612440191,0.007619047619047619,True
167200,905862,112,15,1270,1254,1,113,0,97,0.13392857142857142,12.927835051546392,11.339285714285714,0.0,True
167235,913788,831,2,13353,13233,1029,1860,0,829,0.0024067388688327317,15.962605548854041,16.068592057761734,0.0,True
167238,949420,5,0,4,4,1,6,0,5,0.0,0.8,0.8,0.0,True
167242,911214,2,0,36,36,0,2,0,2,0.0,18.0,18.0,0.0,False
167244,909892,4,0,42,42,4,8,0,4,0.0,10.5,10.5,0.0,True
167244,909894,1,0,13,13,0,1,0,1,0.0,13.0,13.0,0.0,False
167244,909896,1,0,9,9,0,1,0,1,0.0,9.0,9.0,0.0,False
167246,908078,46,0,785,785,69,115,0,46,0.0,17.065217391304348,17.065217391304348,0.0,True
167246,908080,7,0,102,102,1,8,1,7,0.0,14.571428571428571,14.571428571428571,0.125,True
167246,908082,31,0,330,330,20,51,1,31,0.0,10.64516129032258,10.64516129032258,0.0196078431372549,True
167250,913984,1,0,17,17,11,12,10,1,0.0,17.0,17.0,0.8333333333333334,True
167250,929542,0,0,0,0,2,2,2,0,,,,1.0,True
167250,929544,0,0,0,0,66,66,0,0,,,,0.0,True
167263,907972,6,0,78,78,8,14,1,6,0.0,13.0,13.0,0.07142857142857142,True
167263,907974,3,0,29,29,0,3,0,3,0.0,9.666666666666666,9.666666666666666,0.0,False
167264,919552,1239,1,42315,42261,70,1309,3,1238,0.0008071025020177562,34.13651050080775,34.152542372881356,0.002291825821237586,True
167264,919554,1346,11,43525,43133,14,1360,3,1335,0.008172362555720654,32.309363295880146,32.33655274888559,0.0022058823529411764,True
167272,910018,133,0,3197,3197,0,133,4,133,0.0,24.037593984962406,24.037593984962406,0.03007518796992481,False
167272,912684,28,1,1010,950,0,28,3,27,0.03571428571428571,35.18518518518518,36.07142857142857,0.10714285714285714,False
167275,919536,2,0,18,18,13,15,0,2,0.0,9.0,9.0,0.0,True
167275,946020,1,0,3,3,0,1,0,1,0.0,3.0,3.0,0.0,False
167275,946032,1,0,8,8,0,1,0,1,0.0,8.0,8.0,0.0,False
167275,967310,1,0,8,8,58,59,8,1,0.0,8.0,8.0,0.13559322033898305,True
167277,910224,11,0,153,153,0,11,0,11,0.0,13.909090909090908,13.909090909090908,0.0,False
167285,908640,0,0,0,0,16699,16699,7,0,,,,0.0004191867776513564,True
167286,909768,14,0,588,588,0,14,0,14,0.0,42.0,42.0,0.0,False
167286,910540,169,1,3540,3526,0,169,0,168,0.005917159763313609,20.988095238095237,20.94674556213018,0.0,False
167288,908718,0,0,0,0,3,3,1,0,,,,0.3333333333333333,True
167338,912252,42,0,665,665,269,311,0,42,0.0,15.833333333333334,15.833333333333334,0.0,True
167359,912722,175,0,1044,1044,432,607,191,175,0.0,5.965714285714285,5.965714285714285,0.31466227347611203,True
167359,915358,0,0,0,0,277,277,266,0,,,,0.9602888086642599,True
167359,915360,0,0,0,0,287,287,169,0,,,,0.5888501742160279,True
167359,918452,0,0,0,0,327,327,188,0,,,,0.5749235474006116,True
167359,920146,0,0,0,0,90,90,31,0,,,,0.34444444444444444,True
167359,921316,0,0,0,0,87,87,51,0,,,,0.5862068965517241,True
167359,924356,0,0,0,0,268,268,219,0,,,,0.8171641791044776,True
167359,924370,0,0,0,0,16,16,13,0,,,,0.8125,True
167364,924572,0,0,0,0,1,1,0,0,,,,0.0,True
167397,927142,4,0,15,15,3,7,0,4,0.0,3.75,3.75,0.0,True
167402,912010,146,2,2664,2615,0,146,2,144,0.0136986301369863,18.15972222222222,18.246575342465754,0.0136986301369863,False
167412,914440,30,1,573,556,1,31,3,29,0.03333333333333333,19.17241379310345,19.1,0.0967741935483871,True
167412,954290,12,0,232,232,0,12,1,12,0.0,19.333333333333332,19.333333333333332,0.08333333333333333,False
167412,965942,4,0,51,51,0,4,2,4,0.0,12.75,12.75,0.5,False
167436,914256,25,0,383,383,1,26,0,25,0.0,15.32,15.32,0.0,True
167436,914266,0,0,0,0,5,5,2,0,,,,0.4,True
167436,914272,0,0,0,0,1,1,0,0,,,,0.0,True
167436,939886,0,0,0,0,311,311,13,0,,,,0.04180064308681672,True
167436,961552,3,0,104,104,17,20,13,3,0.0,34.666666666666664,34.666666666666664,0.65,True
167445,920706,81,6,1918,1808,171,252,22,75,0.07407407407407407,24.106666666666666,23.679012345679013,0.0873015873015873,True
167445,920720,137,0,2305,2305,210,347,3,137,0.0,16.824817518248175,16.824817518248175,0.008645533141210375,True
167445,920726,59,2,875,817,61,120,1,57,0.03389830508474576,14.333333333333334,14.830508474576272,0.008333333333333333,True
167445,920728,204,4,3285,3179,108,312,22,200,0.0196078431372549,15.895,16.102941176470587,0.07051282051282051,True
167445,920732,120,0,1690,1690,175,295,4,120,0.0,14.083333333333334,14.083333333333334,0.013559322033898305,True
167445,920838,67,0,782,782,189,256,2,67,0.0,11.671641791044776,11.671641791044776,0.0078125,True
167445,920852,197,3,2157,2096,308,505,1,194,0.015228426395939087,10.804123711340207,10.949238578680204,0.0019801980198019802,True
167445,920902,59,1,2793,2742,21,80,0,58,0.01694915254237288,47.275862068965516,47.33898305084746,0.0,True
167445,921062,120,0,1330,1330,8,128,3,120,0.0,11.083333333333334,11.083333333333334,0.0234375,True
167445,935956,2,0,105,105,1,3,0,2,0.0,52.5,52.5,0.0,True
167445,943066,100,0,1296,1296,193,293,0,100,0.0,12.96,12.96,0.0,True
167451,914168,1,0,11,11,10,11,0,1,0.0,11.0,11.0,0.0,True
167451,914170,15,0,177,177,4,19,0,15,0.0,11.8,11.8,0.0,True
167451,914172,12,0,138,138,0,12,0,12,0.0,11.5,11.5,0.0,False
167451,951290,1,0,17,17,20,21,0,1,0.0,17.0,17.0,0.0,True
167455,918390,0,0,0,0,262,262,0,0,,,,0.0,True
167456,921102,13,0,264,264,17,30,11,13,0.0,20.307692307692307,20.307692307692307,0.36666666666666664,True
167456,921104,6,0,123,123,9,15,6,6,0.0,20.5,20.5,0.4,True
167466,921814,52,4,354,334,48,100,6,48,0.07692307692307693,6.958333333333333,6.8076923076923075,0.06,True
167466,921818,2004,11,20869,20696,2306,4310,19,1993,0.0054890219560878245,10.384345208228801,10.413672654690618,0.004408352668213457,True
167471,944644,30,0,727,727,147,177,9,30,0.0,24.233333333333334,24.233333333333334,0.05084745762711865,True
167471,944646,280,1,2857,2847,368,648,5,279,0.0035714285714285713,10.204301075268818,10.20357142857143,0.007716049382716049,True
167471,944648,5,0,198,198,47,52,31,5,0.0,39.6,39.6,0.5961538461538461,True
167471,952656,4,0,30,30,41,45,13,4,0.0,7.5,7.5,0.28888888888888886,True
167474,913780,5,0,89,89,0,5,0,5,0.0,17.8,17.8,0.0,False
167475,914636,3,0,28,28,15,18,3,3,0.0,9.333333333333334,9.333333333333334,0.16666666666666666,True
167475,914816,0,0,0,0,7,7,3,0,,,,0.42857142857142855,True
167475,914842,6,0,113,113,0,6,0,6,0.0,18.833333333333332,18.833333333333332,0.0,False
167475,930660,4,0,26,26,20,24,8,4,0.0,6.5,6.5,0.3333333333333333,True
167475,930662,0,0,0,0,23,23,0,0,,,,0.0,True
167479,915556,196,3,1319,1297,2225,2421,6,193,0.015306122448979591,6.72020725388601,6.729591836734694,0.0024783147459727386,True
167479,915558,0,0,0,0,161,161,3,0,,,,0.018633540372670808,True
167487,914050,12,0,102,102,426,438,3,12,0.0,8.5,8.5,0.00684931506849315,True
167487,914052,0,0,0,0,1468,1468,0,0,,,,0.0,True
167487,914240,0,0,0,0,56,56,0,0,,,,0.0,True
167487,940968,18,0,313,313,0,18,0,18,0.0,17.38888888888889,17.38888888888889,0.0,False
167497,914426,3,0,69,69,4,7,0,3,0.0,23.0,23.0,0.0,True
167497,914848,2,0,37,37,20,22,0,2,0.0,18.5,18.5,0.0,True
167497,914870,5,0,84,84,4,9,1,5,0.0,16.8,16.8,0.1111111111111111,True
167497,915958,11,0,223,223,23,34,2,11,0.0,20.272727272727273,20.272727272727273,0.058823529411764705,True
167497,917252,7,0,266,266,14,21,5,7,0.0,38.0,38.0,0.23809523809523808,True
167497,917378,3,0,38,38,14,17,2,3,0.0,12.666666666666666,12.666666666666666,0.11764705882352941,True
167497,917446,0,0,0,0,15,15,0,0,,,,0.0,True
167497,918956,2,0,69,69,17,19,0,2,0.0,34.5,34.5,0.0,True
167497,918958,2,0,74,74,8,10,7,2,0.0,37.0,37.0,0.7,True
167497,920928,0,0,0,0,16,16,10,0,,,,0.625,True
167497,920930,1,0,62,62,0,1,0,1,0.0,62.0,62.0,0.0,False
167497,921116,0,0,0,0,122,122,40,0,,,,0.32786885245901637,True
167497,922114,1,0,61,61,12,13,6,1,0.0,61.0,61.0,0.46153846153846156,True
167497,924928,33,1,1245,1235,59,92,56,32,0.030303030303030304,38.59375,37.72727272727273,0.6086956521739131,True
167497,924930,22,1,468,459,246,268,61,21,0.045454545454545456,21.857142857142858,21.272727272727273,0.22761194029850745,True
167497,924932,3,0,54,54,33,36,28,3,0.0,18.0,18.0,0.7777777777777778,True
167497,924934,5,0,192,192,621,626,203,5,0.0,38.4,38.4,0.3242811501597444,True
167497,924936,8,2,154,127,0,8,0,6,0.25,21.166666666666668,19.25,0.0,False
167497,924940,8,0,164,164,215,223,53,8,0.0,20.5,20.5,0.23766816143497757,True
167497,924946,8,0,239,239,48,56,32,8,0.0,29.875,29.875,0.5714285714285714,True
167497,924948,17,1,307,300,265,282,41,16,0.058823529411764705,18.75,18.058823529411764,0.1453900709219858,True
167497,924950,31,0,694,694,312,343,137,31,0.0,22.387096774193548,22.387096774193548,0.39941690962099125,True
167497,924952,26,0,579,579,92,118,36,26,0.0,22.26923076923077,22.26923076923077,0.3050847457627119,True
167497,924954,20,1,646,615,120,140,47,19,0.05,32.36842105263158,32.3,0.3357142857142857,True
167497,924956,38,0,685,685,68,106,23,38,0.0,18.026315789473685,18.026315789473685,0.2169811320754717,True
167497,924958,31,0,385,385,242,273,77,31,0.0,12.419354838709678,12.419354838709678,0.28205128205128205,True
167497,924960,54,1,1180,1171,249,303,98,53,0.018518518518518517,22.09433962264151,21.85185185185185,0.3234323432343234,True
167497,932836,22,0,278,278,324,346,70,22,0.0,12.636363636363637,12.636363636363637,0.2023121387283237,True
167497,932856,0,0,0,0,4,4,0,0,,,,0.0,True
167497,950672,1,0,13,13,53,54,19,1,0.0,13.0,13.0,0.35185185185185186,True
167506,919956,13,0,137,137,0,13,1,13,0.0,10.538461538461538,10.538461538461538,0.07692307692307693,False
167506,919958,2,0,35,35,0,2,0,2,0.0,17.5,17.5,0.0,False
167506,923744,1,0,5,5,0,1,0,1,0.0,5.0,5.0,0.0,False
167521,919790,1793,0,59626,59626,25,1818,0,1793,0.0,33.25488008923592,33.25488008923592,0.0,True
167521,919792,829,2,24927,24801,84,913,0,827,0.0024125452352231603,29.98911729141475,30.06875753920386,0.0,True
167521,919794,1327,1,38463,38446,21,1348,0,1326,0.0007535795026375283,28.99396681749623,28.984928409947248,0.0,True
167521,944210,133,0,4685,4685,51,184,0,133,0.0,35.225563909774436,35.225563909774436,0.0,True
167521,944228,31,0,1539,1539,5,36,0,31,0.0,49.645161290322584,49.645161290322584,0.0,True
167521,944246,9,0,333,333,1,10,0,9,0.0,37.0,37.0,0.0,True
167521,944560,5,0,89,89,1,6,0,5,0.0,17.8,17.8,0.0,True
167521,944808,256,0,582,582,0,256,0,256,0.0,2.2734375,2.2734375,0.0,False
167521,946916,32,0,462,462,0,32,0,32,0.0,14.4375,14.4375,0.0,False
167521,956664,1,0,9,9,0,1,0,1,0.0,9.0,9.0,0.0,False
167521,961770,82,0,890,890,0,82,1,82,0.0,10.853658536585366,10.853658536585366,0.012195121951219513,False
167521,962268,45,0,730,730,106,151,1,45,0.0,16.22222222222222,16.22222222222222,0.006622516556291391,True
167530,915504,0,0,0,0,33,33,0,0,,,,0.0,True
167532,917846,3,0,25,25,41,44,10,3,0.0,8.333333333333334,8.333333333333334,0.22727272727272727,True
167532,917850,186,1,3148,3129,171,357,73,185,0.005376344086021506,16.913513513513514,16.9247311827957,0.20448179271708683,True
167532,917852,428,1,8057,8036,1114,1542,10,427,0.002336448598130841,18.81967213114754,18.824766355140188,0.00648508430609598,True
167532,917856,3,0,33,33,78,81,2,3,0.0,11.0,11.0,0.024691358024691357,True
167532,917858,1,0,14,14,4,5,4,1,0.0,14.0,14.0,0.8,True
167533,917876,9,0,125,125,2,11,0,9,0.0,13.88888888888889,13.88888888888889,0.0,True
167534,929332,41,0,603,603,0,41,0,41,0.0,14.707317073170731,14.707317073170731,0.0,False
167534,929340,8,0,349,349,0,8,2,8,0.0,43.625,43.625,0.25,False
167543,928382,12,1,38,35,11,23,0,11,0.08333333333333333,3.1818181818181817,3.1666666666666665,0.0,True
167545,916618,55,0,1144,1144,120,175,2,55,0.0,20.8,20.8,0.011428571428571429,True
167545,964510,16,2,168,160,143,159,3,14,0.125,11.428571428571429,10.5,0.018867924528301886,True
167551,919214,21,0,570,570,1,22,1,21,0.0,27.142857142857142,27.142857142857142,0.045454545454545456,True
167551,919218,21,1,283,278,304,325,33,20,0.047619047619047616,13.9,13.476190476190476,0.10153846153846154,True
167575,926872,25,3,20,17,7,32,0,22,0.12,0.7727272727272727,0.8,0.0,True
167575,930264,4,0,39,39,0,4,0,4,0.0,9.75,9.75,0.0,False
167580,936382,1,0,39,39,484,485,4,1,0.0,39.0,39.0,0.008247422680412371,True
167580,937156,0,0,0,0,67,67,10,0,,,,0.14925373134328357,True
167580,937352,0,0,0,0,31,31,4,0,,,,0.12903225806451613,True
167580,937362,5,0,253,253,6,11,5,5,0.0,50.6,50.6,0.45454545454545453,True
167580,937366,3,0,161,161,3,6,1,3,0.0,53.666666666666664,53.666666666666664,0.16666666666666666,True
167580,937368,23,4,544,448,11,34,8,19,0.17391304347826086,23.57894736842105,23.652173913043477,0.23529411764705882,True
167580,937370,1,0,7,7,7,8,7,1,0.0,7.0,7.0,0.875,True
167580,937372,0,0,0,0,1282,1282,3,0,,,,0.00234009360374415,True
167580,937374,30,0,1057,1057,0,30,0,30,0.0,35.233333333333334,35.233333333333334,0.0,False
167580,945728,0,0,0,0,117,117,0,0,,,,0.0,True
167580,956298,0,0,0,0,16,16,1,0,,,,0.0625,True
167580,960666,0,0,0,0,2,2,2,0,,,,1.0,True
167580,960670,0,0,0,0,3,3,0,0,,,,0.0,True
167580,960672,0,0,0,0,278,278,10,0,,,,0.03597122302158273,True
167580,960674,0,0,0,0,2,2,2,0,,,,1.0,True
167599,954086,31,0,64,64,1,32,0,31,0.0,2.064516129032258,2.064516129032258,0.0,True
167621,918888,8,1,75,69,3,11,0,7,0.125,9.857142857142858,9.375,0.0,True
167626,919162,0,0,0,0,2933,2933,0,0,,,,0.0,True
167626,919164,722,3,4481,4450,11,733,0,719,0.004155124653739612,6.189151599443671,6.206371191135734,0.0,True
167626,919166,1209,7,6777,6732,21,1230,0,1202,0.005789909015715467,5.6006655574043265,5.60545905707196,0.0,True
167626,919188,0,0,0,0,864,864,0,0,,,,0.0,True
167626,919190,2,0,22,22,83,85,0,2,0.0,11.0,11.0,0.0,True
167626,919192,0,0,0,0,2233,2233,2,0,,,,0.0008956560680698612,True
167626,919194,0,0,0,0,1565,1565,0,0,,,,0.0,True
167626,919196,0,0,0,0,2896,2896,0,0,,,,0.0,True
167626,919198,0,0,0,0,1113,1113,0,0,,,,0.0,True
167626,919200,0,0,0,0,1297,1297,4,0,,,,0.0030840400925212026,True
167626,919202,0,0,0,0,2853,2853,0,0,,,,0.0,True
167626,919204,1309,9,10427,10351,9,1318,0,1300,0.006875477463712758,7.962307692307692,7.965622612681436,0.0,True
167626,919206,999,12,7940,7822,1,1000,0,987,0.012012012012012012,7.925025329280649,7.947947947947948,0.0,True
167626,919302,0,0,0,0,2528,2528,0,0,,,,0.0,True
167626,919306,0,0,0,0,1664,1664,0,0,,,,0.0,True
167626,919310,0,0,0,0,2569,2569,0,0,,,,0.0,True
167626,919314,0,0,0,0,2794,2794,2,0,,,,0.0007158196134574087,True
167626,919318,0,0,0,0,1846,1846,0,0,,,,0.0,True
167626,919362,0,0,0,0,2546,2546,0,0,,,,0.0,True
167626,919364,0,0,0,0,5096,5096,0,0,,,,0.0,True
167626,919370,0,0,0,0,1324,1324,0,0,,,,0.0,True
167626,919372,0,0,0,0,1627,1627,0,0,,,,0.0,True
167626,919374,0,0,0,0,2214,2214,0,0,,,,0.0,True
167626,919376,0,0,0,0,1415,1415,1,0,,,,0.0007067137809187279,True
167626,919378,0,0,0,0,1227,1227,0,0,,,,0.0,True
167626,919382,0,0,0,0,1827,1827,0,0,,,,0.0,True
167626,919390,0,0,0,0,831,831,0,0,,,,0.0,True
167626,919456,0,0,0,0,1517,1517,0,0,,,,0.0,True
167626,919464,0,0,0,0,1296,1296,0,0,,,,0.0,True
167626,919476,0,0,0,0,2105,2105,1,0,,,,0.00047505938242280285,True
167626,919482,0,0,0,0,1549,1549,0,0,,,,0.0,True
167626,919490,0,0,0,0,1803,1803,0,0,,,,0.0,True
167626,919504,0,0,0,0,2214,2214,0,0,,,,0.0,True
167626,919906,0,0,0,0,1710,1710,3,0,,,,0.0017543859649122807,True
167626,919910,0,0,0,0,377,377,0,0,,,,0.0,True
167626,920414,0,0,0,0,1266,1266,0,0,,,,0.0,True
167626,920416,0,0,0,0,1697,1697,0,0,,,,0.0,True
167626,921574,0,0,0,0,1778,1778,0,0,,,,0.0,True
167626,921584,0,0,0,0,1346,1346,0,0,,,,0.0,True
167626,921592,0,0,0,0,1805,1805,0,0,,,,0.0,True
167626,921594,0,0,0,0,1145,1145,0,0,,,,0.0,True
167626,921596,0,0,0,0,1502,1502,0,0,,,,0.0,True
167626,922710,0,0,0,0,1784,1784,0,0,,,,0.0,True
167626,923666,0,0,0,0,2074,2074,3,0,,,,0.0014464802314368371,True
167626,925134,0,0,0,0,44,44,0,0,,,,0.0,True
167626,928228,0,0,0,0,69,69,0,0,,,,0.0,True
167626,928518,0,0,0,0,337,337,0,0,,,,0.0,True
167626,934426,0,0,0,0,222,222,0,0,,,,0.0,True
167630,920666,204,1,1826,1819,305,509,0,203,0.004901960784313725,8.960591133004925,8.950980392156863,0.0,True
167634,918436,40,1,768,749,865,905,1,39,0.025,19.205128205128204,19.2,0.0011049723756906078,True
167644,924544,108,0,707,707,13,121,0,108,0.0,6.546296296296297,6.546296296296297,0.0,True
167644,924546,48,1,740,720,83,131,0,47,0.020833333333333332,15.319148936170214,15.416666666666666,0.0,True
167645,919126,0,0,0,0,291,291,3,0,,,,0.010309278350515464,True
167645,919128,0,0,0,0,388,388,0,0,,,,0.0,True
167646,964712,9,0,164,164,12,21,9,9,0.0,18.22222222222222,18.22222222222222,0.42857142857142855,True
167650,921306,475,4,10327,10257,592,1067,1,471,0.008421052631578947,21.777070063694268,21.74105263157895,0.0009372071227741331,True
167650,921318,2485,7,36448,36175,2864,5349,14,2478,0.0028169014084507044,14.598466505246167,14.667203219315896,0.0026173116470368293,True
167650,921320,80,1,1830,1788,317,397,0,79,0.0125,22.632911392405063,22.875,0.0,True
167650,931458,2129,14,36038,35535,2561,4690,14,2115,0.006575857209957727,16.80141843971631,16.92719586660404,0.0029850746268656717,True
167653,939706,653,4,6088,6062,1027,1680,7,649,0.006125574272588055,9.340523882896765,9.32312404287902,0.004166666666666667,True
167653,939708,10,1,124,119,36,46,0,9,0.1,13.222222222222221,12.4,0.0,True
167654,918978,769,4,7600,7541,1360,2129,2,765,0.005201560468140442,9.857516339869282,9.882964889466841,0.0009394081728511038,True
167654,918986,713,0,6981,6981,1623,2336,3,713,0.0,9.791023842917252,9.791023842917252,0.0012842465753424657,True
167654,918988,1,0,13,13,1,2,0,1,0.0,13.0,13.0,0.0,True
167664,920874,33,0,913,913,0,33,0,33,0.0,27.666666666666668,27.666666666666668,0.0,False
167682,922154,2,0,18,18,0,2,0,2,0.0,9.0,9.0,0.0,False
167715,926184,42,0,495,495,32,74,4,42,0.0,11.785714285714286,11.785714285714286,0.05405405405405406,True
167715,926214,3,0,27,27,0,3,0,3,0.0,9.0,9.0,0.0,False
167715,935958,35,1,779,771,0,35,4,34,0.02857142857142857,22.676470588235293,22.257142857142856,0.11428571428571428,False
167716,922142,0,0,0,0,792,792,3,0,,,,0.003787878787878788,True
167727,926486,16,0,133,133,2610,2626,0,16,0.0,8.3125,8.3125,0.0,True
167742,951526,18,0,262,262,0,18,0,18,0.0,14.555555555555555,14.555555555555555,0.0,False
167742,955032,38,1,328,317,36,74,1,37,0.02631578947368421,8.567567567567568,8.631578947368421,0.013513513513513514,True
167742,955164,2,0,52,52,3,5,0,2,0.0,26.0,26.0,0.0,True
167744,928022,8,0,124,124,0,8,0,8,0.0,15.5,15.5,0.0,False
167747,922428,30,0,251,251,230,260,23,30,0.0,8.366666666666667,8.366666666666667,0.08846153846153847,True
167747,922474,91,0,712,712,231,322,52,91,0.0,7.824175824175824,7.824175824175824,0.16149068322981366,True
167747,922476,0,0,0,0,207,207,56,0,,,,0.27053140096618356,True
167747,922486,1,0,8,8,7,8,6,1,0.0,8.0,8.0,0.75,True
167756,938896,1224,5,9414,9362,2393,3617,6,1219,0.004084967320261438,7.680065627563577,7.6911764705882355,0.0016588332872546309,True
167759,922698,4,0,43,43,12,16,3,4,0.0,10.75,10.75,0.1875,True
167781,923944,43,0,504,504,0,43,0,43,0.0,11.720930232558139,11.720930232558139,0.0,False
167792,933832,28,0,720,720,0,28,0,28,0.0,25.714285714285715,25.714285714285715,0.0,False
167799,925104,919,0,6952,6952,1367,2286,1,919,0.0,7.564744287268771,7.564744287268771,0.0004374453193350831,True
167805,924614,7,0,43,43,16,23,0,7,0.0,6.142857142857143,6.142857142857143,0.0,True
167816,928312,19,0,275,275,1956,1975,17,19,0.0,14.473684210526315,14.473684210526315,0.008607594936708861,True
167819,927908,5,0,13,13,0,5,0,5,0.0,2.6,2.6,0.0,False
167819,927910,31,1,81,80,0,31,0,30,0.03225806451612903,2.6666666666666665,2.6129032258064515,0.0,False
167819,927912,17,1,46,42,0,17,0,16,0.058823529411764705,2.625,2.7058823529411766,0.0,False
167819,927916,147,0,300,300,488,635,0,147,0.0,2.0408163265306123,2.0408163265306123,0.0,True
167827,929424,1432,5,1889,1880,4006,5438,2,1427,0.0034916201117318434,1.317449194113525,1.3191340782122905,0.0003677822728944465,True
167827,929426,0,0,0,0,12041,12041,0,0,,,,0.0,True
167827,929428,0,0,0,0,24572,24572,0,0,,,,0.0,True
167828,938612,73,0,379,379,138,211,0,73,0.0,5.191780821917808,5.191780821917808,0.0,True
167828,938614,44,1,261,249,30,74,0,43,0.022727272727272728,5.790697674418604,5.931818181818182,0.0,True
167828,940430,76,1,73,72,27,103,0,75,0.013157894736842105,0.96,0.9605263157894737,0.0,True
167828,940432,144,0,1071,1071,178,322,0,144,0.0,7.4375,7.4375,0.0,True
167828,940434,126,0,623,623,156,282,0,126,0.0,4.944444444444445,4.944444444444445,0.0,True
167828,940436,32,0,343,343,7,39,0,32,0.0,10.71875,10.71875,0.0,True
167828,940438,73,0,394,394,416,489,0,73,0.0,5.397260273972603,5.397260273972603,0.0,True
167828,940440,46,0,519,519,14,60,0,46,0.0,11.282608695652174,11.282608695652174,0.0,True
167828,940442,223,3,152,149,353,576,0,220,0.013452914798206279,0.6772727272727272,0.6816143497757847,0.0,True
167829,969272,225,1,2180,2141,241,466,23,224,0.0044444444444444444,9.558035714285714,9.688888888888888,0.04935622317596566,True
167840,952968,2,0,10,10,2,4,0,2,0.0,5.0,5.0,0.0,True
167847,928142,8,0,110,110,0,8,0,8,0.0,13.75,13.75,0.0,False
167852,930690,2,0,13,13,4,6,0,2,0.0,6.5,6.5,0.0,True
167852,930692,0,0,0,0,6,6,0,0,,,,0.0,True
167852,932798,121,1,1182,1167,12,133,1,120,0.008264462809917356,9.725,9.768595041322314,0.007518796992481203,True
167870,936110,168,0,2646,2646,0,168,0,168,0.0,15.75,15.75,0.0,False
167888,928886,60,1,505,489,773,833,1,59,0.016666666666666666,8.288135593220339,8.416666666666666,0.0012004801920768306,True
167888,928888,349,1,2778,2771,659,1008,7,348,0.0028653295128939827,7.962643678160919,7.959885386819484,0.006944444444444444,True
167888,930020,89,5,729,672,602,691,7,84,0.056179775280898875,8.0,8.191011235955056,0.010130246020260492,True
167906,928404,5,0,77,77,0,5,0,5,0.0,15.4,15.4,0.0,False
167906,939698,2,0,26,26,1,3,0,2,0.0,13.0,13.0,0.0,True
167908,971354,6,0,84,84,0,6,0,6,0.0,14.0,14.0,0.0,False
167923,928926,1,0,5,5,15,16,0,1,0.0,5.0,5.0,0.0,True
167923,951408,0,0,0,0,40,40,0,0,,,,0.0,True
167923,973120,0,0,0,0,3,3,0,0,,,,0.0,True
167927,929622,14,0,203,203,4,18,0,14,0.0,14.5,14.5,0.0,True
167927,929626,42,0,519,519,21,63,1,42,0.0,12.357142857142858,12.357142857142858,0.015873015873015872,True
167930,930814,12,0,187,187,3,15,0,12,0.0,15.583333333333334,15.583333333333334,0.0,True
167930,930816,4,0,51,51,1,5,0,4,0.0,12.75,12.75,0.0,True
167930,930818,3,0,41,41,0,3,0,3,0.0,13.666666666666666,13.666666666666666,0.0,False
167930,930820,5,0,71,71,2,7,0,5,0.0,14.2,14.2,0.0,True
167936,931914,33,0,542,542,0,33,0,33,0.0,16.424242424242426,16.424242424242426,0.0,False
167947,930582,1,0,16,16,0,1,0,1,0.0,16.0,16.0,0.0,False
167947,930586,0,0,0,0,230,230,1,0,,,,0.004347826086956522,True
167947,930590,0,0,0,0,68,68,1,0,,,,0.014705882352941176,True
167947,930594,2,0,21,21,54,56,0,2,0.0,10.5,10.5,0.0,True
167948,930326,11,0,130,130,1,12,0,11,0.0,11.818181818181818,11.818181818181818,0.0,True
167949,929876,36,1,492,481,93,129,12,35,0.027777777777777776,13.742857142857142,13.666666666666666,0.09302325581395349,True
167949,929884,33,0,548,548,26,59,1,33,0.0,16.606060606060606,16.606060606060606,0.01694915254237288,True
167949,941384,52,0,585,585,706,758,2,52,0.0,11.25,11.25,0.002638522427440633,True
167949,968232,1,0,13,13,0,1,0,1,0.0,13.0,13.0,0.0,False
167955,930186,7,0,35,35,56,63,0,7,0.0,5.0,5.0,0.0,True
167955,941192,0,0,0,0,1239,1239,0,0,,,,0.0,True
167958,951186,92,0,792,792,9,101,2,92,0.0,8.608695652173912,8.608695652173912,0.019801980198019802,True
167958,969294,84,0,710,710,14,98,4,84,0.0,8.452380952380953,8.452380952380953,0.04081632653061224,True
167969,932750,12,0,115,115,17,29,0,12,0.0,9.583333333333334,9.583333333333334,0.0,True
167969,932754,2,0,11,11,3,5,0,2,0.0,5.5,5.5,0.0,True
167969,946582,44,0,80,80,33,77,0,44,0.0,1.8181818181818181,1.8181818181818181,0.0,True
167976,934424,8,0,221,221,0,8,0,8,0.0,27.625,27.625,0.0,False
167976,934428,41,0,967,967,0,41,0,41,0.0,23.585365853658537,23.585365853658537,0.0,False
167976,934430,31,2,846,794,0,31,0,29,0.06451612903225806,27.379310344827587,27.29032258064516,0.0,False
167976,934432,9,0,324,324,0,9,0,9,0.0,36.0,36.0,0.0,False
167977,944216,288,32,10295,8583,147,435,0,256,0.1111111111111111,33.52734375,35.74652777777778,0.0,True
167977,944218,272,16,9983,9219,179,451,0,256,0.058823529411764705,36.01171875,36.70220588235294,0.0,True
167977,944220,329,21,11763,10721,232,561,0,308,0.06382978723404255,34.80844155844156,35.753799392097264,0.0,True
167977,944222,192,17,6535,5868,372,564,0,175,0.08854166666666667,33.53142857142857,34.036458333333336,0.0,True
167977,944226,202,38,8850,6681,134,336,0,164,0.18811881188118812,40.73780487804878,43.81188118811881,0.0,True
167989,935394,1,0,7,7,0,1,0,1,0.0,7.0,7.0,0.0,False
167989,936296,0,0,0,0,4,4,1,0,,,,0.25,True
167989,936324,31,0,435,435,131,162,4,31,0.0,14.03225806451613,14.03225806451613,0.024691358024691357,True
167989,954376,0,0,0,0,4,4,3,0,,,,0.75,True
167989,954378,0,0,0,0,8,8,7,0,,,,0.875,True
167989,954380,0,0,0,0,4,4,4,0,,,,1.0,True
167994,933986,16,1,193,190,10,26,2,15,0.0625,12.666666666666666,12.0625,0.07692307692307693,True
167994,933996,4,0,102,102,11,15,4,4,0.0,25.5,25.5,0.26666666666666666,True
167994,934000,8,0,122,122,2,10,2,8,0.0,15.25,15.25,0.2,True
167995,934188,6,0,104,104,2,8,0,6,0.0,17.333333333333332,17.333333333333332,0.0,True
167995,941838,0,0,0,0,9,9,0,0,,,,0.0,True
167995,941842,0,0,0,0,3,3,0,0,,,,0.0,True
167995,941844,8,1,138,120,12,20,0,7,0.125,17.142857142857142,17.25,0.0,True
167998,941786,3,0,39,39,0,3,0,3,0.0,13.0,13.0,0.0,False
167998,944908,2,0,27,27,0,2,0,2,0.0,13.5,13.5,0.0,False
167999,933804,25,0,346,346,0,25,0,25,0.0,13.84,13.84,0.0,False
167999,933806,0,0,0,0,391,391,3,0,,,,0.0076726342710997444,True
167999,933810,0,0,0,0,108,108,0,0,,,,0.0,True
168000,933244,2,0,18,18,84,86,0,2,0.0,9.0,9.0,0.0,True
168000,968338,16,0,136,136,259,275,0,16,0.0,8.5,8.5,0.0,True
168004,934098,6,2,159,83,0,6,2,4,0.3333333333333333,20.75,26.5,0.3333333333333333,False
168008,946988,3,0,30,30,5,8,0,3,0.0,10.0,10.0,0.0,True
168008,948524,4,0,22,22,0,4,0,4,0.0,5.5,5.5,0.0,False
168010,932672,7,0,10,10,0,7,0,7,0.0,1.4285714285714286,1.4285714285714286,0.0,False
168010,932676,0,0,0,0,4,4,0,0,,,,0.0,True
168016,935870,8,0,103,103,0,8,0,8,0.0,12.875,12.875,0.0,False
168018,945894,0,0,0,0,1506,1506,0,0,,,,0.0,True
168018,945898,0,0,0,0,3,3,0,0,,,,0.0,True
168018,945900,0,0,0,0,4817,4817,1,0,,,,0.00020759809009757111,True
168018,945902,0,0,0,0,3310,3310,0,0,,,,0.0,True
168018,945904,0,0,0,0,4080,4080,0,0,,,,0.0,True
168019,935216,2,0,10,10,34,36,7,2,0.0,5.0,5.0,0.19444444444444445,True
168019,965232,0,0,0,0,38,38,4,0,,,,0.10526315789473684,True
168021,939218,11,0,87,87,377,388,0,11,0.0,7.909090909090909,7.909090909090909,0.0,True
168021,939222,35,0,424,424,945,980,0,35,0.0,12.114285714285714,12.114285714285714,0.0,True
168021,939224,35,1,562,549,1516,1551,0,34,0.02857142857142857,16.147058823529413,16.057142857142857,0.0,True
168021,968150,4,0,4,4,100,104,0,4,0.0,1.0,1.0,0.0,True
168025,933070,67,1,436,430,782,849,0,66,0.014925373134328358,6.515151515151516,6.507462686567164,0.0,True
168025,938022,15,0,156,156,265,280,1,15,0.0,10.4,10.4,0.0035714285714285713,True
168025,938070,0,0,0,0,671,671,0,0,,,,0.0,True
168025,938072,0,0,0,0,494,494,0,0,,,,0.0,True
168025,938074,0,0,0,0,664,664,0,0,,,,0.0,True
168025,938078,0,0,0,0,856,856,1,0,,,,0.0011682242990654205,True
168025,938080,0,0,0,0,742,742,0,0,,,,0.0,True
168041,934534,133,2,2449,2428,0,133,2,131,0.015037593984962405,18.53435114503817,18.413533834586467,0.015037593984962405,False
168041,936514,83,1,1561,1541,0,83,6,82,0.012048192771084338,18.79268292682927,18.80722891566265,0.07228915662650602,False
168042,934170,8,0,82,82,0,8,0,8,0.0,10.25,10.25,0.0,False
168047,937604,7,0,80,80,56,63,6,7,0.0,11.428571428571429,11.428571428571429,0.09523809523809523,True
168048,950806,9,0,88,88,4,13,0,9,0.0,9.777777777777779,9.777777777777779,0.0,True
168054,971100,3,0,26,26,0,3,0,3,0.0,8.666666666666666,8.666666666666666,0.0,False
168054,971102,78,0,1370,1370,0,78,0,78,0.0,17.564102564102566,17.564102564102566,0.0,False
168062,947590,0,0,0,0,190,190,7,0,,,,0.03684210526315789,True
168062,947592,0,0,0,0,910,910,3,0,,,,0.0032967032967032967,True
168062,947596,0,0,0,0,1,1,0,0,,,,0.0,True
168062,947598,0,0,0,0,492,492,11,0,,,,0.022357723577235773,True
168062,947600,0,0,0,0,321,321,16,0,,,,0.04984423676012461,True
168062,947604,1,0,14,14,975,976,11,1,0.0,14.0,14.0,0.011270491803278689,True
168062,947610,2,0,19,19,22,24,16,2,0.0,9.5,9.5,0.6666666666666666,True
168062,947612,1,0,18,18,123,124,8,1,0.0,18.0,18.0,0.06451612903225806,True
168062,947614,0,0,0,0,995,995,14,0,,,,0.01407035175879397,True
168062,947616,0,0,0,0,2151,2151,13,0,,,,0.00604370060437006,True
168062,947618,0,0,0,0,1134,1134,18,0,,,,0.015873015873015872,True
168062,947620,0,0,0,0,1277,1277,13,0,,,,0.010180109631949883,True
168062,947636,0,0,0,0,109,109,2,0,,,,0.01834862385321101,True
168062,947638,2,0,27,27,1342,1344,14,2,0.0,13.5,13.5,0.010416666666666666,True
168062,947640,0,0,0,0,538,538,12,0,,,,0.022304832713754646,True
168062,947642,1,0,14,14,968,969,13,1,0.0,14.0,14.0,0.013415892672858616,True
168062,947644,0,0,0,0,470,470,13,0,,,,0.027659574468085105,True
168062,947646,0,0,0,0,1984,1984,6,0,,,,0.0030241935483870967,True
168062,947648,0,0,0,0,3071,3071,9,0,,,,0.002930641484858352,True
168062,947650,0,0,0,0,1791,1791,10,0,,,,0.005583472920156337,True
168062,947652,0,0,0,0,575,575,9,0,,,,0.01565217391304348,True
168062,947654,0,0,0,0,2619,2619,12,0,,,,0.004581901489117984,True
168062,947658,0,0,0,0,2855,2855,20,0,,,,0.0070052539404553416,True
168062,951492,30,0,679,679,166,196,83,30,0.0,22.633333333333333,22.633333333333333,0.42346938775510207,True
168062,951506,43,0,1769,1769,218,261,201,43,0.0,41.13953488372093,41.13953488372093,0.7701149425287356,True
168062,951508,339,24,6437,5959,153,492,136,315,0.07079646017699115,18.917460317460318,18.9882005899705,0.2764227642276423,True
168062,952392,0,0,0,0,1557,1557,12,0,,,,0.007707129094412331,True
168064,934476,1,0,13,13,10,11,11,1,0.0,13.0,13.0,1.0,True
168064,939762,935,0,15913,15913,2045,2980,27,935,0.0,17.019251336898396,17.019251336898396,0.009060402684563758,True
168073,937422,0,0,0,0,37,37,31,0,,,,0.8378378378378378,True
168073,937428,0,0,0,0,8,8,8,0,,,,1.0,True
168073,937430,0,0,0,0,34,34,34,0,,,,1.0,True
168073,937432,3,1,36,23,25,28,25,2,0.3333333333333333,11.5,12.0,0.8928571428571429,True
168073,941736,0,0,0,0,11,11,11,0,,,,1.0,True
168073,941740,0,0,0,0,8,8,4,0,,,,0.5,True
168073,941810,0,0,0,0,6,6,5,0,,,,0.8333333333333334,True
168073,941816,0,0,0,0,1,1,1,0,,,,1.0,True
168073,941826,0,0,0,0,1,1,1,0,,,,1.0,True
168073,953362,0,0,0,0,10,10,7,0,,,,0.7,True
168073,954284,0,0,0,0,1,1,1,0,,,,1.0,True
168090,964518,2,0,42,42,0,2,0,2,0.0,21.0,21.0,0.0,False
168091,958430,22,0,409,409,303,325,105,22,0.0,18.59090909090909,18.59090909090909,0.3230769230769231,True
168091,958432,17,0,458,458,171,188,43,17,0.0,26.941176470588236,26.941176470588236,0.22872340425531915,True
168091,958434,24,1,924,911,144,168,83,23,0.041666666666666664,39.608695652173914,38.5,0.49404761904761907,True
168091,958440,0,0,0,0,90,90,89,0,,,,0.9888888888888889,True
168091,958444,0,0,0,0,78,78,76,0,,,,0.9743589743589743,True
168091,958452,38,1,441,436,479,517,37,37,0.02631578947368421,11.783783783783784,11.605263157894736,0.07156673114119923,True
168091,958454,2,0,30,30,24,26,24,2,0.0,15.0,15.0,0.9230769230769231,True
168091,958456,10,0,264,264,876,886,32,10,0.0,26.4,26.4,0.03611738148984198,True
168091,958458,0,0,0,0,1,1,1,0,,,,1.0,True
168091,958460,113,3,5656,5497,114,227,60,110,0.02654867256637168,49.972727272727276,50.05309734513274,0.2643171806167401,True
168091,958468,9,0,319,319,528,537,23,9,0.0,35.44444444444444,35.44444444444444,0.04283054003724395,True
168091,958470,4,0,203,203,13,17,0,4,0.0,50.75,50.75,0.0,True
168091,958472,0,0,0,0,33,33,2,0,,,,0.06060606060606061,True
168091,958478,7,0,237,237,322,329,7,7,0.0,33.857142857142854,33.857142857142854,0.02127659574468085,True
168091,958480,0,0,0,0,176,176,0,0,,,,0.0,True
168091,958672,0,0,0,0,55,55,53,0,,,,0.9636363636363636,True
168093,941390,1,0,5,5,376,377,0,1,0.0,5.0,5.0,0.0,True
168097,935244,2,0,38,38,28,30,0,2,0.0,19.0,19.0,0.0,True
168097,935246,0,0,0,0,7,7,0,0,,,,0.0,True
168097,935264,4,0,28,28,66,70,0,4,0.0,7.0,7.0,0.0,True
168097,935268,5,0,48,48,0,5,0,5,0.0,9.6,9.6,0.0,False
168101,935548,19,0,207,207,5,24,2,19,0.0,10.894736842105264,10.894736842105264,0.08333333333333333,True
168105,936984,75,0,1059,1059,0,75,0,75,0.0,14.12,14.12,0.0,False
168105,951118,4,0,130,130,0,4,0,4,0.0,32.5,32.5,0.0,False
168105,970484,0,0,0,0,7,7,0,0,,,,0.0,True
168105,970486,0,0,0,0,6,6,0,0,,,,0.0,True
168110,938432,10,0,200,200,0,10,0,10,0.0,20.0,20.0,0.0,False
168121,940456,26,0,214,214,33,59,15,26,0.0,8.23076923076923,8.23076923076923,0.2542372881355932,True
168121,940458,26,0,833,833,70,96,9,26,0.0,32.03846153846154,32.03846153846154,0.09375,True
168121,940460,0,0,0,0,86,86,5,0,,,,0.05813953488372093,True
168121,940474,0,0,0,0,30,30,13,0,,,,0.43333333333333335,True
168121,940486,0,0,0,0,23,23,6,0,,,,0.2608695652173913,True
168121,940508,2,0,83,83,0,2,1,2,0.0,41.5,41.5,0.5,False
168121,940512,1,0,19,19,0,1,0,1,0.0,19.0,19.0,0.0,False
168121,940514,1,0,11,11,0,1,0,1,0.0,11.0,11.0,0.0,False
168128,937650,0,0,0,0,91,91,0,0,,,,0.0,True
168154,939370,502,4,9445,9327,518,1020,0,498,0.00796812749003984,18.728915662650603,18.814741035856574,0.0,True
168154,939376,274,1,3850,3825,1205,1479,0,273,0.0036496350364963502,14.010989010989011,14.05109489051095,0.0,True
168155,938414,93,2,2147,2106,53,146,1,91,0.021505376344086023,23.142857142857142,23.086021505376344,0.00684931506849315,True
168155,969288,3,0,88,88,2,5,0,3,0.0,29.333333333333332,29.333333333333332,0.0,True
168180,958640,11,1,113,104,11,22,0,10,0.09090909090909091,10.4,10.272727272727273,0.0,True
168185,939212,9,0,160,160,11,20,1,9,0.0,17.77777777777778,17.77777777777778,0.05,True
168187,937678,20,0,221,221,176,196,5,20,0.0,11.05,11.05,0.025510204081632654,True
168187,937708,205,0,2631,2631,750,955,6,205,0.0,12.834146341463414,12.834146341463414,0.0062827225130890054,True
168187,937710,0,0,0,0,1,1,1,0,,,,1.0,True
168187,937716,0,0,0,0,1,1,0,0,,,,0.0,True
168187,937720,0,0,0,0,1,1,1,0,,,,1.0,True
168187,937732,131,2,2213,2122,194,325,9,129,0.015267175572519083,16.449612403100776,16.893129770992367,0.027692307692307693,True
168187,937736,304,2,3915,3868,1285,1589,30,302,0.006578947368421052,12.80794701986755,12.87828947368421,0.018879798615481436,True
168187,937742,22,0,343,343,3,25,1,22,0.0,15.590909090909092,15.590909090909092,0.04,True
168187,937750,61,1,775,759,46,107,1,60,0.01639344262295082,12.65,12.704918032786885,0.009345794392523364,True
168187,937752,493,0,5327,5327,1760,2253,17,493,0.0,10.8052738336714,10.8052738336714,0.007545494895694629,True
168187,937760,351,1,4037,3991,762,1113,31,350,0.002849002849002849,11.402857142857142,11.501424501424502,0.027852650494159928,True
168187,937762,99,1,1310,1295,228,327,11,98,0.010101010101010102,13.214285714285714,13.232323232323232,0.03363914373088685,True
168187,937770,0,0,0,0,1,1,0,0,,,,0.0,True
168187,937772,0,0,0,0,1,1,0,0,,,,0.0,True
168187,937774,140,0,959,959,176,316,3,140,0.0,6.85,6.85,0.00949367088607595,True
168187,937778,0,0,0,0,1,1,0,0,,,,0.0,True
168187,937780,170,2,1875,1833,962,1132,27,168,0.011764705882352941,10.910714285714286,11.029411764705882,0.023851590106007067,True
168187,937782,25,0,334,334,30,55,0,25,0.0,13.36,13.36,0.0,True
168187,937786,3,0,27,27,12,15,5,3,0.0,9.0,9.0,0.3333333333333333,True
168187,937788,134,0,1533,1533,535,669,4,134,0.0,11.440298507462687,11.440298507462687,0.005979073243647235,True
168187,937808,146,1,1660,1625,921,1067,16,145,0.00684931506849315,11.206896551724139,11.36986301369863,0.01499531396438613,True
168187,937810,99,0,871,871,308,407,14,99,0.0,8.797979797979798,8.797979797979798,0.0343980343980344,True
168187,937812,182,2,2495,2479,215,397,17,180,0.01098901098901099,13.772222222222222,13.708791208791208,0.042821158690176324,True
168187,937854,207,0,1902,1902,599,806,25,207,0.0,9.18840579710145,9.18840579710145,0.031017369727047148,True
168187,937856,11,0,120,120,32,43,1,11,0.0,10.909090909090908,10.909090909090908,0.023255813953488372,True
168187,937860,240,8,2066,2020,1531,1771,13,232,0.03333333333333333,8.706896551724139,8.608333333333333,0.007340485601355167,True
168187,937862,127,0,1461,1461,374,501,3,127,0.0,11.503937007874017,11.503937007874017,0.005988023952095809,True
168187,937864,49,1,500,494,60,109,15,48,0.02040816326530612,10.291666666666666,10.204081632653061,0.13761467889908258,True
168187,937868,67,1,728,717,278,345,2,66,0.014925373134328358,10.863636363636363,10.865671641791044,0.005797101449275362,True
168187,937870,0,0,0,0,13,13,0,0,,,,0.0,True
168187,937872,0,0,0,0,1,1,0,0,,,,0.0,True
168187,937874,23,1,219,211,149,172,1,22,0.043478260869565216,9.590909090909092,9.521739130434783,0.005813953488372093,True
168187,937880,7,0,65,65,0,7,1,7,0.0,9.285714285714286,9.285714285714286,0.14285714285714285,False
168187,937888,213,0,1728,1728,1020,1233,8,213,0.0,8.112676056338028,8.112676056338028,0.006488240064882401,True
168187,937898,9,2,68,54,38,47,6,7,0.2222222222222222,7.714285714285714,7.555555555555555,0.1276595744680851,True
168187,937900,0,0,0,0,4,4,0,0,,,,0.0,True
168187,937902,257,1,3066,3038,959,1216,8,256,0.0038910505836575876,11.8671875,11.929961089494164,0.006578947368421052,True
168187,937956,901,25,1201,1174,1,902,17,876,0.02774694783573807,1.3401826484018264,1.332963374028857,0.018847006651884702,True
168187,937958,303,9,2115,2044,0,303,8,294,0.0297029702970297,6.9523809523809526,6.98019801980198,0.026402640264026403,False
168187,937960,227,2,2544,2522,0,227,5,225,0.00881057268722467,11.20888888888889,11.20704845814978,0.022026431718061675,False
168187,937962,117,4,1950,1916,0,117,9,113,0.03418803418803419,16.95575221238938,16.666666666666668,0.07692307692307693,False
168187,937966,265,3,2245,2211,865,1130,15,262,0.011320754716981131,8.438931297709924,8.471698113207546,0.01327433628318584,True
168187,937980,91,0,945,945,145,236,22,91,0.0,10.384615384615385,10.384615384615385,0.09322033898305085,True
168187,937984,27,0,252,252,41,68,28,27,0.0,9.333333333333334,9.333333333333334,0.4117647058823529,True
168187,937988,81,0,899,899,284,365,1,81,0.0,11.098765432098766,11.098765432098766,0.0027397260273972603,True
168187,946072,1,0,6,6,1,2,1,1,0.0,6.0,6.0,0.5,True
168187,948282,1,0,1,1,0,1,0,1,0.0,1.0,1.0,0.0,False
168187,948284,4,0,107,107,0,4,0,4,0.0,26.75,26.75,0.0,False
168187,948286,384,18,6116,6050,0,384,7,366,0.046875,16.530054644808743,15.927083333333334,0.018229166666666668,False
168187,948288,24,1,309,305,0,24,0,23,0.041666666666666664,13.26086956521739,12.875,0.0,False
168190,952982,9,0,8,8,0,9,0,9,0.0,0.8888888888888888,0.8888888888888888,0.0,False
168193,947816,14,0,262,262,30,44,3,14,0.0,18.714285714285715,18.714285714285715,0.06818181818181818,True
168193,947818,15,0,153,153,37,52,0,15,0.0,10.2,10.2,0.0,True
168193,947820,0,0,0,0,17,17,0,0,,,,0.0,True
168193,948150,32,0,319,319,9,41,2,32,0.0,9.96875,9.96875,0.04878048780487805,True
168193,948170,2,0,30,30,3,5,0,2,0.0,15.0,15.0,0.0,True
168193,951046,3,0,42,42,55,58,1,3,0.0,14.0,14.0,0.017241379310344827,True
168202,944564,2,0,28,28,0,2,0,2,0.0,14.0,14.0,0.0,False
168221,944474,6,0,150,150,13,19,0,6,0.0,25.0,25.0,0.0,True
168221,944476,203,0,2749,2749,17,220,0,203,0.0,13.541871921182265,13.541871921182265,0.0,True
168221,952292,2,0,81,81,0,2,0,2,0.0,40.5,40.5,0.0,False
168225,970240,1,0,44,44,1,2,0,1,0.0,44.0,44.0,0.0,True
168225,970242,0,0,0,0,10,10,2,0,,,,0.2,True
168225,970244,2,0,81,81,2,4,1,2,0.0,40.5,40.5,0.25,True
168225,970250,0,0,0,0,1,1,0,0,,,,0.0,True
168225,970252,1,0,25,25,7,8,0,1,0.0,25.0,25.0,0.0,True
168225,970254,3,0,121,121,9,12,3,3,0.0,40.333333333333336,40.333333333333336,0.25,True
168225,970258,0,0,0,0,1,1,0,0,,,,0.0,True
168228,939684,19,0,273,273,142,161,15,19,0.0,14.368421052631579,14.368421052631579,0.09316770186335403,True
168228,939736,0,0,0,0,19,19,13,0,,,,0.6842105263157895,True
168228,939738,0,0,0,0,692,692,6,0,,,,0.008670520231213872,True
168252,939716,14,0,69,69,16,30,8,14,0.0,4.928571428571429,4.928571428571429,0.26666666666666666,True
168252,939718,0,0,0,0,10,10,0,0,,,,0.0,True
168252,940568,3,0,18,18,7,10,5,3,0.0,6.0,6.0,0.5,True
168252,940588,2382,30,7393,7283,77,2459,25,2352,0.012594458438287154,3.0965136054421767,3.1036943744752308,0.010166734444896299,True
168252,940596,1,0,4,4,489,490,15,1,0.0,4.0,4.0,0.030612244897959183,True
168252,940610,2,0,8,8,1,3,2,2,0.0,4.0,4.0,0.6666666666666666,True
168252,940614,145,3,471,457,574,719,7,142,0.020689655172413793,3.2183098591549295,3.2482758620689656,0.009735744089012517,True
168252,940616,645,6,3605,3573,2691,3336,39,639,0.009302325581395349,5.591549295774648,5.589147286821706,0.011690647482014389,True
168252,940622,729,18,3270,3168,815,1544,12,711,0.024691358024691357,4.455696202531645,4.48559670781893,0.007772020725388601,True
168252,940624,597,8,3397,3364,1217,1814,24,589,0.01340033500837521,5.711375212224109,5.690117252931323,0.013230429988974642,True
168252,940630,2100,17,8666,8566,180,2280,35,2083,0.008095238095238095,4.112337974075852,4.126666666666667,0.015350877192982455,True
168252,940634,491,7,3739,3666,1743,2234,11,484,0.014256619144602852,7.574380165289257,7.615071283095723,0.004923903312444047,True
168252,940652,414,9,1717,1686,968,1382,9,405,0.021739130434782608,4.162962962962963,4.147342995169082,0.006512301013024602,True
168252,940658,939,13,4555,4454,1850,2789,33,926,0.013844515441959531,4.809935205183585,4.850905218317359,0.011832197920401577,True
168252,940772,2,0,9,9,0,2,2,2,0.0,4.5,4.5,1.0,False
168252,940782,0,0,0,0,11,11,9,0,,,,0.8181818181818182,True
168252,940788,0,0,0,0,11,11,11,0,,,,1.0,True
168252,940802,0,0,0,0,5,5,1,0,,,,0.2,True
168252,940814,0,0,0,0,2,2,0,0,,,,0.0,True
168252,940828,2,0,4,4,13,15,3,2,0.0,2.0,2.0,0.2,True
168252,940842,0,0,0,0,2,2,2,0,,,,1.0,True
168252,940848,0,0,0,0,2,2,0,0,,,,0.0,True
168252,944310,3,0,15,15,0,3,2,3,0.0,5.0,5.0,0.6666666666666666,False
168252,950972,4,0,117,117,893,897,0,4,0.0,29.25,29.25,0.0,True
168252,956080,5,0,252,252,0,5,0,5,0.0,50.4,50.4,0.0,False
168252,961064,24,0,182,182,904,928,0,24,0.0,7.583333333333333,7.583333333333333,0.0,True
168252,964666,45,3,609,592,875,920,2,42,0.06666666666666667,14.095238095238095,13.533333333333333,0.002173913043478261,True
168252,966686,2,0,33,33,1,3,3,2,0.0,16.5,16.5,1.0,True
168253,952948,4112,8,6625,6616,1311,5423,39,4104,0.0019455252918287938,1.612085769980507,1.61113813229572,0.007191591370090356,True
168253,952954,3,0,3,3,0,3,0,3,0.0,1.0,1.0,0.0,False
168264,951490,33,1,459,449,0,33,0,32,0.030303030303030304,14.03125,13.909090909090908,0.0,False
168271,944764,355,2,2473,2463,290,645,0,353,0.005633802816901409,6.977337110481586,6.966197183098592,0.0,True
168271,944766,152,1,1374,1365,143,295,0,151,0.006578947368421052,9.039735099337749,9.039473684210526,0.0,True
168271,954650,462,3,4809,4783,1014,1476,27,459,0.006493506493506494,10.420479302832245,10.409090909090908,0.018292682926829267,True
168275,940952,164,0,2090,2090,110,274,0,164,0.0,12.74390243902439,12.74390243902439,0.0,True
168291,946454,0,0,0,0,13,13,0,0,,,,0.0,True
168295,960620,79,1,1133,1119,64,143,0,78,0.012658227848101266,14.346153846153847,14.341772151898734,0.0,True
168295,960648,33,0,579,579,79,112,1,33,0.0,17.545454545454547,17.545454545454547,0.008928571428571428,True
168303,949252,3,0,40,40,0,3,0,3,0.0,13.333333333333334,13.333333333333334,0.0,False
168307,945046,73,5,1343,1215,32,105,3,68,0.0684931506849315,17.86764705882353,18.397260273972602,0.02857142857142857,True
168307,945052,74,2,935,921,22,96,6,72,0.02702702702702703,12.791666666666666,12.635135135135135,0.0625,True
168307,945058,4,0,75,75,1,5,0,4,0.0,18.75,18.75,0.0,True
168315,952734,452,0,499,499,0,452,0,452,0.0,1.1039823008849559,1.1039823008849559,0.0,False
168336,947304,43,4,233,205,784,827,32,39,0.09302325581395349,5.256410256410256,5.4186046511627906,0.03869407496977025,True
168336,947306,2,0,20,20,0,2,0,2,0.0,10.0,10.0,0.0,False
168336,948756,1,1,8,0,175,176,18,0,1.0,,8.0,0.10227272727272728,True
168336,948758,19,1,482,441,657,676,24,18,0.05263157894736842,24.5,25.36842105263158,0.03550295857988166,True
168336,958416,15,1,285,260,310,325,12,14,0.06666666666666667,18.571428571428573,19.0,0.036923076923076927,True
168336,958418,12,0,107,107,494,506,25,12,0.0,8.916666666666666,8.916666666666666,0.04940711462450593,True
168336,966158,3,0,45,45,34,37,11,3,0.0,15.0,15.0,0.2972972972972973,True
168336,967204,0,0,0,0,3,3,3,0,,,,1.0,True
168336,969262,0,0,0,0,1,1,1,0,,,,1.0,True
168336,969268,0,0,0,0,5,5,2,0,,,,0.4,True
168336,969284,0,0,0,0,1,1,1,0,,,,1.0,True
168336,969286,0,0,0,0,8,8,2,0,,,,0.25,True
168336,969380,1,0,21,21,14,15,14,1,0.0,21.0,21.0,0.9333333333333333,True
168336,969386,0,0,0,0,55,55,2,0,,,,0.03636363636363636,True
168361,945074,0,0,0,0,3,3,0,0,,,,0.0,True
168361,945274,0,0,0,0,1,1,0,0,,,,0.0,True
168361,945278,0,0,0,0,4314,4314,1,0,,,,0.0002318034306907742,True
168361,945280,0,0,0,0,2538,2538,3,0,,,,0.001182033096926714,True
168361,945282,0,0,0,0,2582,2582,1,0,,,,0.0003872966692486445,True
168361,945284,0,0,0,0,2210,2210,2,0,,,,0.0009049773755656109,True
168361,945286,0,0,0,0,7919,7919,9,0,,,,0.0011365071347392347,True
168361,945288,0,0,0,0,2260,2260,0,0,,,,0.0,True
168361,945290,0,0,0,0,3943,3943,0,0,,,,0.0,True
168361,945294,0,0,0,0,3434,3434,0,0,,,,0.0,True
168361,945296,0,0,0,0,2821,2821,2,0,,,,0.0007089684509039348,True
168361,945298,0,0,0,0,1600,1600,15,0,,,,0.009375,True
168361,945302,0,0,0,0,7059,7059,2,0,,,,0.0002833262501770789,True
168361,945304,0,0,0,0,2918,2918,0,0,,,,0.0,True
168361,945308,0,0,0,0,1761,1761,0,0,,,,0.0,True
168361,945310,0,0,0,0,3580,3580,2,0,,,,0.0005586592178770949,True
168361,945312,0,0,0,0,2519,2519,0,0,,,,0.0,True
168361,945314,0,0,0,0,1861,1861,4,0,,,,0.0021493820526598604,True
168361,945316,0,0,0,0,2751,2751,2,0,,,,0.0007270083605961468,True
168361,945318,0,0,0,0,1998,1998,0,0,,,,0.0,True
168361,945320,0,0,0,0,2605,2605,0,0,,,,0.0,True
168361,945322,0,0,0,0,5015,5015,2,0,,,,0.00039880358923230307,True
168361,945324,0,0,0,0,2254,2254,1,0,,,,0.00044365572315882877,True
168361,965538,0,0,0,0,548,548,0,0,,,,0.0,True
168361,965540,0,0,0,0,919,919,0,0,,,,0.0,True
168361,965542,0,0,0,0,776,776,14,0,,,,0.01804123711340206,True
168361,965544,0,0,0,0,1277,1277,1,0,,,,0.0007830853563038371,True
168366,952666,1,0,15,15,0,1,1,1,0.0,15.0,15.0,1.0,False
168366,952678,1,0,30,30,0,1,0,1,0.0,30.0,30.0,0.0,False
168377,968368,2,0,38,38,0,2,0,2,0.0,19.0,19.0,0.0,False
168412,952458,0,0,0,0,1738,1738,26,0,,,,0.014959723820483314,True
168412,952460,0,0,0,0,199,199,6,0,,,,0.03015075376884422,True
168412,952462,10,0,218,218,2,12,0,10,0.0,21.8,21.8,0.0,True
168412,952466,0,0,0,0,134,134,9,0,,,,0.06716417910447761,True
168412,952468,0,0,0,0,1184,1184,102,0,,,,0.08614864864864864,True
168412,953458,0,0,0,0,61,61,0,0,,,,0.0,True
168412,953460,0,0,0,0,10,10,2,0,,,,0.2,True
168412,953462,0,0,0,0,761,761,69,0,,,,0.09067017082785808,True
168412,953464,67,2,629,617,396,463,31,65,0.029850746268656716,9.492307692307692,9.388059701492537,0.06695464362850972,True
168416,948182,136,0,1740,1740,491,627,2,136,0.0,12.794117647058824,12.794117647058824,0.003189792663476874,True
168459,968520,10,0,10,10,0,10,0,10,0.0,1.0,1.0,0.0,False
168464,950632,1,0,13,13,0,1,0,1,0.0,13.0,13.0,0.0,False
168464,950634,9,0,110,110,0,9,0,9,0.0,12.222222222222221,12.222222222222221,0.0,False
168466,952114,1,0,3,3,691,692,0,1,0.0,3.0,3.0,0.0,True
168466,952116,0,0,0,0,354,354,0,0,,,,0.0,True
168473,956268,7,0,113,113,22,29,0,7,0.0,16.142857142857142,16.142857142857142,0.0,True
168481,956276,8,0,53,53,10,18,1,8,0.0,6.625,6.625,0.05555555555555555,True
168481,956292,3,0,35,35,2,5,1,3,0.0,11.666666666666666,11.666666666666666,0.2,True
168481,959596,0,0,0,0,9,9,0,0,,,,0.0,True
168500,952196,2,0,24,24,3,5,1,2,0.0,12.0,12.0,0.2,True
168522,951614,7,0,106,106,0,7,0,7,0.0,15.142857142857142,15.142857142857142,0.0,False
168562,960698,6,0,101,101,0,6,0,6,0.0,16.833333333333332,16.833333333333332,0.0,False
168575,953940,1,0,9,9,0,1,0,1,0.0,9.0,9.0,0.0,False
168575,953952,9,0,124,124,0,9,0,9,0.0,13.777777777777779,13.777777777777779,0.0,False
168579,954810,37,0,336,336,0,37,0,37,0.0,9.08108108108108,9.08108108108108,0.0,False
168579,973286,2,0,88,88,0,2,0,2,0.0,44.0,44.0,0.0,False
168583,952126,7,0,101,101,0,7,0,7,0.0,14.428571428571429,14.428571428571429,0.0,False
168583,962062,22,0,300,300,0,22,0,22,0.0,13.636363636363637,13.636363636363637,0.0,False
168598,958394,23,0,171,171,0,23,0,23,0.0,7.434782608695652,7.434782608695652,0.0,False
168601,952914,98,0,729,729,607,705,1,98,0.0,7.438775510204081,7.438775510204081,0.0014184397163120568,True
168601,952916,1,0,25,25,7,8,0,1,0.0,25.0,25.0,0.0,True
168603,959118,0,0,0,0,17,17,0,0,,,,0.0,True
168606,957922,3,1,26,19,20,23,12,2,0.3333333333333333,9.5,8.666666666666666,0.5217391304347826,True
